tl2_abbrev	surname	full_name	full_name_simplified
Aario	Aario	Aario, Leo Eino	Aario, Leo Eino
Aasen	Aasen	Aasen, Ivar Andreas	Aasen, Ivar Andreas
F.Abbott	Abbott	Abbott, Francis, Jr.	Abbott, Francis, Jr.
L.Abel	Abel	Abel, Lothar	Abel, Lothar
O.Abel	Abel	Abel, Othenio	Abel, Othenio
Abele	Abele	Abele, Karlis	Abele, Karlis
Abendroth	Abendroth	Abendroth, Wilhelm Friedrich	Abendroth, Wilhelm Friedrich
Abercr.	Abercrombie	Abercrombie, John	Abercrombie, John
Aberle	Aberle	Aberle, Carl	Aberle, Carl
Abraham	Abraham	Abraham, Max	Abraham, Max
Achar.	Acharius	Acharius, Erik	Acharius, Erik
Achner	Achner	Achner, Adolph	Achner, Adolph
Acosta Solis	Acosta Solis	Acosta Solis, Misael	Acosta Solis, Misael
J.Adam	Adam	Adam, Jean	Adam, Jean
G.Adams, Jr.	Adams	Adams, George Jr.	Adams, George Jr.
G.Adams, Sr.	Adams	Adams, George Sr.	Adams, George Sr.
M.F.Adams	Adams	Adams, [Adam], [Johann] Michael Friedrich	Adams, Michael Friedrich
Adamski	Adamski	Adamski, Maximilien [Maximilianus Joseph Adalbertus Andreas Antonius]	Adamski, Maximilien
Aderhold	Aderhold	Aderhold, Rudolf Ferdinand Theodor	Aderhold, Rudolf Ferdinand Theodor
Aderholdt	Aderholdt	Aderholdt, August Eduard	Aderholdt, August Eduard
W.Adler	Adler	Adler, Wilhelm	Adler, Wilhelm
Adriani	Adriani	Adriani, Marcus Jan	Adriani, Marcus Jan
A.A.Afzel.	Afzelius	Afzelius, Arvid August	Afzelius, Arvid August
P.C.Afzel.	Afzelius	Afzelius, Pehr Conrad	Afzelius, Pehr Conrad
J.Agassiz	Agassiz	Agassiz, Jean Louis Rodolphe	Agassiz, Jean Louis Rodolphe
Agharkar	Agharkar	Agharkar, Shankar Purusottum	Agharkar, Shankar Purusottum
Agnethler	Agnethler	Agnethler, Michael Gottlieb, Ritter von	Agnethler, Michael Gottlieb, Ritter von
Agnér	Agnér	Agnér, Gustaf Frederik Hjalmar	Agnér, Gustaf Frederik Hjalmar
Ahern	Ahern	Ahern, George Patrick	Ahern, George Patrick
Ahlfvengren	Ahlfvengren	Ahlfvengren, Frederik Elias	Ahlfvengren, Frederik Elias
Ahlquist	Ahlquist	Ahlquist, Abraham	Ahlquist, Abraham
Ahnfelt	Ahnfelt	Ahnfelt, Nils Otto	Ahnfelt, Nils Otto
Aichinger	Aichinger von Aichenhayn	Aichinger von Aichenhayn, Josef	Aichinger von Aichenhayn, Josef
Aikin	Aikin	Aikin, John	Aikin, John
W.Aikin	Aikin	Aikin, William Edward Augustin	Aikin, William Edward Augustin
W.Ainslie	Ainslie	Ainslie, [Sir] Whitelaw	Ainslie, Whitelaw
Aisslinger	Aisslinger	Aisslinger, Hans	Aisslinger, Hans
A.Albert	Albert	Albert, Abel	Albert, Abel
F.Albert	Albert	Albert, Federico	Albert, Federico
Ant.Alberti	Alberti	Alberti, Antonio	Alberti, Antonio
Albertini	Albertini	Albertini, Johann Baptist von	Albertini, Johann Baptist von
Alboff	Alboff	Alboff, Nicolas Michailowitch	Alboff, Nicolas Michailowitch
Alcenius	Alcenius	Alcenius, Otto Alfred	Alcenius, Otto Alfred
Alexopoulos	Alexopoulos	Alexopoulos, Constantine John	Alexopoulos, Constantine John
Alix	Alix	Alix, [Sieur]	Alix
Allam.	Allamand	Allamand, Jean Frédéric François Louis	Allamand, Jean Frédéric François Louis
H.H.Allan	Allan	Allan, Harry Howard [Barton]	Allan, Harry Howard
C.G.B.Allen	Allen	Allen, [Charles] Grant [Blairfindie]	Allen, Grant
R.F.Allen	Allen	Allen, Ruth Florence	Allen, Ruth Florence
T.F.Allen	Allen	Allen, Timothy Field	Allen, Timothy Field
W.E.Allen	Allen	Allen, Winfred Emory	Allen, Winfred Emory
Allram	Allram	Allram, Raimund [Robert]	Allram, Raimund
C.Alm	Alm	Alm, Carl Gustav	Alm, Carl Gustav
Alschinger	Alschinger	Alschinger, Andreas	Alschinger, Andreas
C.Alston	Alston	Alston, Charles	Alston, Charles
Altamirano	Altamirano	Altamirano, Fernando	Altamirano, Fernando
P.Altmann	Altmann	Altmann, Paul	Altmann, Paul
Alvthin	Alvthin [from 1895; earlier Johansson]	Alvthin [from 1895; earlier Johansson], Nils	Alvthin, Nils
O.Amberg	Amberg	Amberg, Otto	Amberg, Otto
Amblard	Amblard	Amblard, Francisque	Amblard, Francisque
L.Ames	Ames	Ames, Lawrence Marion	Ames, Lawrence Marion
Amoreux	Amoreux	Amoreux, Pierre-Joseph	Amoreux, Pierre-Joseph
Anas.	Anastasia	Anastasia, Guiseppe Emilio	Anastasia, Guiseppe Emilio
A.Andersen	Andersen	Andersen, Anton	Andersen, Anton
Anderson, Andrew	Anderson	Anderson, Andrew	Anderson, Andrew
C.W.Anderson	Anderson	Anderson, Charles Wilgress	Anderson, Charles Wilgress
E.Anderson	Anderson	Anderson, Edgar [Shannon]	Anderson, Edgar
Anderss.	Andersson	Andersson, Nils Johan	Andersson, Nils Johan
Ax.Anderss.	Andersson	Andersson, Axel	Andersson, Axel
C.Anderss.	Andersson	Andersson, Carl	Andersson, Carl
O.F.Anderss.	Andersson	Andersson, Oscar Frederik (also Oscar Frederic Borge)	Andersson, Oscar Frederik
S.A.E.Anderss.	Andersson	Andersson, Sigrid Ahlfild Elisabeth	Andersson, Sigrid Ahlfild Elisabeth
J.Andreas	Andreas	Andreas, John	Andreas, John
A.L.Andr.	Andrews	Andrews, Albert Le Roy	Andrews, Albert Le Roy
C.W.Andr.	Andrews	Andrews, Charles William	Andrews, Charles William
E.B.Andr.	Andrews	Andrews, Ebenezer Baldwin	Andrews, Ebenezer Baldwin
L.Andr.	Andrews	Andrews, Luman	Andrews, Luman
Andreanszky	Andreánsky	Andreánsky, Gábor (Gabriel) [Baron]	Andreánsky, Gábor
Andrzejovski	Andrzejowski	Andrzejowski, Antoni Lukianowicz	Andrzejowski, Antoni Lukianowicz
Eug.André	André	André, Eugène	André, Eugène
Andrée	Andrée	Andrée, Adolf	Andrée, Adolf
Angreville	Angreville	Angreville, Jacques Étienne d	Angreville, Jacques Étienne d
Ansberque	Ansberque	Ansberque, Edme	Ansberque, Edme
Anslijn	Anslijn Nie.zn	Anslijn Nie.zn, Nicolaas	Anslijn Nie.zn, Nicolaas
Antevs	Antevs	Antevs, Ernst Valdemar	Antevs, Ernst Valdemar
Antommarchi	Antommarchi	Antommarchi, François [Francesco]	Antommarchi, François
A.C.Apgar	Apgar	Apgar, Austin Craig	Apgar, Austin Craig
E.A.Apgar	Apgar	Apgar, Ellis Ayres	Apgar, Ellis Ayres
Aphonin	Aphonin	Aphonin, Matheus [Matwey]	Aphonin, Matheus
Appl	Appl	Appl, Johann	Appl, Johann
Arbois	Arbois de Jubainville	Arbois de Jubainville, Marie-Alexandre	Arbois de Jubainville, Marie-Alexandre
Archbold	Archbold	Archbold, Andrea B.	Archbold, Andrea B.
T.C.Archer	Archer	Archer, Thomas Croxen	Archer, Thomas Croxen
Ardène	Ardène	Ardène, Jean Paul de Rome d	Ardène, Jean Paul de Rome d
Arena	Arena	Arena, Filippo	Arena, Filippo
G.Arendt	Arendt	Arendt, Georg	Arendt, Georg
P.Arens	Arens	Arens, Pedro [Martin José]	Arens, Pedro
F.Areschoug	Areschoug	Areschoug, Fredric Wilhelm Christian	Areschoug, Fredric Wilhelm Christian
J.Areschoug	Areschoug	Areschoug, Johan [John] Erhard	Areschoug, Johan Erhard
Edw.Armitage	Armitage	Armitage, Rev. Edward	Armitage, Rev. Edward
El.Armitage	Armitage	Armitage, Eleonora	Armitage, Eleonora
J.Arnaud	Arnaud	Arnaud, Jean André Michel	Arnaud, Jean André Michel
F.H.Arnold	Arnold	Arnold, Frederick Henry	Arnold, Frederick Henry
Arnott	Arnott	Arnott, George Arnott [sometimes Arnold] Walker	Arnott, George Arnott Walker
Arrondeau	Arrondeau	Arrondeau, E.-Théodore	Arrondeau, E.-Théodore
Arth.	Arthur	Arthur, Joseph Charles	Arthur, Joseph Charles
Arwidss.	Arwidsson	Arwidsson, Thorsten	Arwidsson, Thorsten
Asah.	Asahina	Asahina, Yasuhiko	Asahina, Yasuhiko
Aschers.	Ascherson	Ascherson, Paul [Friedrich August]	Ascherson, Paul
F.Ascherson	Ascherson	Ascherson, Ferdinand Moritz	Ascherson, Ferdinand Moritz
R.E.Ashton	Ashton	Ashton, Ruth Elisabeth (Mrs. Aven Nelson)	Ashton, Ruth Elisabeth
Ask.	Askenasy	Askenasy, Eugen	Askenasy, Eugen
Asplund	Asplund	Asplund, Erik	Asplund, Erik
Asso del Rio	Asso del Rio	Asso del Rio, Ignacio Jordan de	Asso del Rio, Ignacio Jordan de
Atchley	Atchley	Atchley, Shirles Clifford	Atchley, Shirles Clifford
Athanasius	Athanasius	Athanasius, Eustathius	Athanasius, Eustathius
Attema	Attema	Attema, Jean Joseph	Attema, Jean Joseph
S.Aubert	Aubert	Aubert, Samuel	Aubert, Samuel
Aubréville	Aubréville	Aubréville, André	Aubréville, André
Audouit	Audouit	Audouit, Edmond	Audouit, Edmond
Auer	Auer	Auer, Auvo Vilho	Auer, Auvo Vilho
Aulagne	Aulagne	Aulagne, Émile	Aulagne, Émile
Aulin	Aulin	Aulin, Fredrik Rutger	Aulin, Fredrik Rutger
Aust.	Austin	Austin, Coe Finch	Austin, Coe Finch
Autenrieth	Autenrieth	Autenrieth, Hermann Friedrich	Autenrieth, Hermann Friedrich
Auzende	Auzende	Auzende, Joseph	Auzende, Joseph
Avellino	Avellino	Avellino, Giulio	Avellino, Giulio
Axell	Axell	Axell, Johan Severin	Axell, Johan Severin
Axelson	Axelson [later Linnaniemi]	Axelson [later Linnaniemi], Walter Mikael	Axelson, Walter Mikael
Axt	Axt	Axt, Johann Conrad	Axt, Johann Conrad
Aznavour	Aznavour	Aznavour, Georges Vincent [Aznavur, Jorj Vensan]	Aznavour, Georges Vincent
Baar	Baar	Baar, Paul	Baar, Paul
J.Baas	Baas	Baas, Josef	Baas, Josef
Baas Becking	Baas Becking	Baas Becking, Laurens [Lourens] Gerhard Marinus	Baas Becking, Laurens Gerhard Marinus
Church.Bab.	Babington	Babington, Churchill	Babington, Churchill
Bachinger	Bachinger	Bachinger, Augustin	Bachinger, Augustin
Bachlechner	Bachlechner	Bachlechner, Gregor	Bachlechner, Gregor
J.Bachman	Bachman	Bachman, John	Bachman, John
F.M.Bachman	Bachman [Bachmann]	Bachman [Bachmann], Freda Marie	Bachman, Freda Marie
J.Bachm.	Bachmann	Bachmann, Johann	Bachmann, Johann
O.Bachm.	Bachmann	Bachmann, Otto	Bachmann, Otto
G.Backer	Backer	Backer, Gerard	Backer, Gerard
Backhouse	Backhouse	Backhouse, James Sr.	Backhouse, James Sr.
J.Backhouse Jr.	Backhouse	Backhouse, James, Jr.	Backhouse, James, Jr.
A.L.Backm.	Backman	Backman, Albin Lonnart	Backman, Albin Lonnart
C.J.Backm.	Backman	Backman, Carl Johan	Backman, Carl Johan
Badet	Badet	Badet, Michel	Badet, Michel
Badger	Badger	Badger, Mrs. C.M.	Badger, Mrs. C.M.
Baerecke	Baerecke	Baerecke, John Frederick	Baerecke, John Frederick
Baez	Baez	Baez, Juan Romualdo	Baez, Juan Romualdo
Bahrdt	Bahrdt	Bahrdt, Heinrich [August]	Bahrdt, Heinrich
Ch.Bailey	Bailey	Bailey, Charles	Bailey, Charles
Edw.Bailey	Bailey	Bailey, Edward	Bailey, Edward
W.W.Bailey	Bailey	Bailey, William Whitman	Bailey, William Whitman
Th.Baines, Lancs.	Baines	Baines, Thomas	Baines, Thomas
C.Baker	Baker	Baker, Charles Fuller	Baker, Charles Fuller
E.G.Baker	Baker	Baker, Edmund Gilbert	Baker, Edmund Gilbert
J.P.Bakker	Bakker	Bakker, Jan Pieter	Bakker, Jan Pieter
Baldacci	Baldacci	Baldacci, Antonio	Baldacci, Antonio
Baldw.	Baldwin	Baldwin, William	Baldwin, William
E.G.Balf.	Balfour	Balfour, Edward Green	Balfour, Edward Green
I.B.Balf.	Balfour	Balfour, Isaac Bayley	Balfour, Isaac Bayley
Balicka-Iwanowska	Balicka-Iwanowska	Balicka-Iwanowska, Gabrielle [Gabryela]	Balicka-Iwanowska, Gabrielle
J.Ball	Ball	Ball, John	Ball, John
P.Bally	Bally	Bally, Peter René Oscar	Bally, Peter René Oscar
W.Bally	Bally	Bally, Walter Friedrich Eugen	Bally, Walter Friedrich Eugen
Bancroft	Bancroft	Bancroft, [Claude] Keith	Bancroft, Keith
E.Bancroft	Bancroft	Bancroft, Edward	Bancroft, Edward
E.N.Bancroft	Bancroft	Bancroft, Edward Nathaniel	Bancroft, Edward Nathaniel
H.H.Bancroft	Bancroft	Bancroft, Helen [Nellie] Holme	Bancroft, Helen Holme
Bandi	Bandi	Bandi, Walter	Bandi, Walter
Baranetzky	Baranetzky	Baranetzky, Joseph [Osip, Iosif] Wasiljewitsch	Baranetzky, Joseph Wasiljewitsch
K.G.Barber	Barber	Barber, Kate Grace	Barber, Kate Grace
Barbeu	Barbeu-Dubourg	Barbeu-Dubourg, Jacques	Barbeu-Dubourg, Jacques
Barcianu	Barcianu	Barcianu, Daniel Popoviciú	Barcianu, Daniel Popoviciú
Barckhausen	Barckhausen	Barckhausen, Justus Christian Gottlieb Willibald	Barckhausen, Justus Christian Gottlieb Willibald
Barcl.	Barclay	Barclay, Arthur	Barclay, Arthur
Barentin	Barentin	Barentin, Friedrich Wilhelm	Barentin, Friedrich Wilhelm
Bargagli	Bargagli	Bargagli, Piero (marchese)	Bargagli, Piero
Bargagli-Petrucci	Bargagli-Petrucci	Bargagli-Petrucci, Gino	Bargagli-Petrucci, Gino
Barillet	Barillet	Barillet, J.	Barillet, J.
H.D.Barker	Barker	Barker, Henry D.	Barker, Henry D.
Th.Barker	Barker	Barker, Thomas	Barker, Thomas
Barkl.	Barkley	Barkley, Fred Alexander	Barkley, Fred Alexander
Barnades	Barnades	Barnades, Miguel	Barnades, Miguel
B.F.Barnes	Barnes	Barnes, Bertie Frank	Barnes, Bertie Frank
W.D.Barnes	Barnes	Barnes, William David	Barnes, William David
Barnsby	Barnsby	Barnsby, David	Barnsby, David
E.A.Barth	Barth	Barth, Ernst Adolph	Barth, Ernst Adolph
F.L.Barth	Barth	Barth, Fernand-Léon	Barth, Fernand-Léon
Barthel	Barthel	Barthel, ...	Barthel
Barthels	Barthels	Barthels, Wilhelm	Barthels, Wilhelm
Barth.	Bartholomew	Bartholomew, Elam	Bartholomew, Elam
E.T.Barth.	Bartholomew	Bartholomew, Elbert Thomas	Bartholomew, Elbert Thomas
E.M.Bartlett	Bartlett	Bartlett, Emily Mary	Bartlett, Emily Mary
H.H.Bartlett	Bartlett	Bartlett, Harley Harris	Bartlett, Harley Harris
H.M.Bartlett	Bartlett	Bartlett, Harley Harris	Bartlett, Harley Harris
E.Barton	Barton	Barton, Ethel Sarel	Barton, Ethel Sarel
J.Barton Sr.	Barton	Barton, John [Sr.]	Barton, John
W.Barton	Barton	Barton, William Paul Crillon	Barton, William Paul Crillon
E.Bartsch	Bartsch	Bartsch, Eugen	Bartsch, Eugen
Bartusch	Bartusch	Bartusch, Hildegard	Bartusch, Hildegard
Baruch	Baruch	Baruch, Maximilian Paul	Baruch, Maximilian Paul
Baskerville	Baskerville	Baskerville, Thomas	Baskerville, Thomas
Basse	Basse	Basse, Éliane	Basse, Éliane
E.S.Bastin	Bastin	Bastin, Edson Sewell	Bastin, Edson Sewell
J.Bastin	Bastin	Bastin, Joseph	Bastin, Joseph
Batal.	Batalin	Batalin, Alexander Feodorowicz	Batalin, Alexander Feodorowicz
Batchelder	Batchelder	Batchelder, Frederick William	Batchelder, Frederick William
J.M.Bates	Bates	Bates, John Mallory	Bates, John Mallory
Battand.	Battandier	Battandier, Jules-Aimé	Battandier, Jules-Aimé
Battiscombe	Battiscombe	Battiscombe, Edward (c.q. Eric)	Battiscombe, Edward
Bauhardt	Bauhardt	Bauhardt, L.	Bauhardt, L.
C Bauhin	Bauhin	Bauhin, Caspar (Gaspard)	Bauhin, Caspar
H.Bauke	Bauke	Bauke, Hermann	Bauke, Hermann
C.Baumann	Baumann	Baumann, Charles	Baumann, Charles
Eu.Baumann	Baumann	Baumann, Eugen	Baumann, Eugen
G.Baumg.	Baumgartner	Baumgartner, Gottlieb	Baumgartner, Gottlieb
J.Baumg.	Baumgartner	Baumgartner, [Hofrat] Julius	Baumgartner, Julius
P.Baumg.	Baumgartner	Baumgartner, Paul	Baumgartner, Paul
Baumgärtel	Baumgärtel	Baumgärtel, Otto	Baumgärtel, Otto
E.Baur	Baur	Baur, Erwin	Baur, Erwin
Bautier	Bautier	Bautier, Alexandre	Bautier, Alexandre
J.C.Bay	Bay	Bay, Jens Christian [Ballien]	Bay, Jens Christian
Ad.Bayer	Bayer	Bayer, Adolf Joseph Wilhelm	Bayer, Adolf Joseph Wilhelm
Aug.Bayer	Bayer	Bayer, August	Bayer, August
J.N.Bayer	Bayer	Bayer, Johann Nepomuk	Bayer, Johann Nepomuk
Bayle-Barelle	Bayle-Barelle	Bayle-Barelle, Giuseppe	Bayle-Barelle, Giuseppe
Bazot	Bazot	Bazot, [Marie] Louis	Bazot, Louis
Beauquesne	Beauquesne	Beauquesne, Lucienne	Beauquesne, Lucienne
Beaurieux	Beaurieux	Beaurieux, R.	Beaurieux, R.
Bechtel	Bechtel	Bechtel, Albert Reiff	Bechtel, Albert Reiff
C.Becker	Becker	Becker, Carl	Becker, Carl
H.Becker	Becker	Becker, Hans	Becker, Hans
Johanna Becker	Becker	Becker, Johanna	Becker, Johanna
K.E.Becker	Becker	Becker, Karl Ernst	Becker, Karl Ernst
J.H.Becking	Becking	Becking, Johannes Hendrikus	Becking, Johannes Hendrikus
H.Beekman	Beekman	Beekman, Hendrick Albert Johan Michiel	Beekman, Hendrick Albert Johan Michiel
Beeldsnijder	Beeldsnijder	Beeldsnijder, Gerard Johannes	Beeldsnijder, Gerard Johannes
M.Behm	Behm	Behm, Moritz	Behm, Moritz
O.Behrendsen	Behrendsen	Behrendsen, [August Wilhelm] Otto	Behrendsen, Otto
J.Behrens	Behrens	Behrens, Johannes August	Behrens, Johannes August
W.J.Behrens	Behrens	Behrens, [Georg] Wilhelm Julius	Behrens, Wilhelm Julius
Behuneck	Behuneck	Behuneck, Hugo	Behuneck, Hugo
Beinert	Beinert	Beinert, Carl Christian	Beinert, Carl Christian
E.Beinling	Beinling	Beinling, Ernst	Beinling, Ernst
Th.Beinling	Beinling	Beinling, Theodor Rudolf Berthold	Beinling, Theodor Rudolf Berthold
Bellairs	Bellairs	Bellairs, Nona Maria Stevenson	Bellairs, Nona Maria Stevenson
Bellermann	Bellermann	Bellermann, Johan Bartholomaeus	Bellermann, Johan Bartholomaeus
C.B.Bender	Bender	Bender, Christoph Bernhard	Bender, Christoph Bernhard
Bendrat	Bendrat	Bendrat, Thomas Albert	Bendrat, Thomas Albert
L.Benjamin	Benjamin	Benjamin, Ludwig	Benjamin, Ludwig
E.Benner	Benner	Benner, Ernst	Benner, Ernst
H.L.Bentley	Bentley	Bentley, Henry Lewis	Bentley, Henry Lewis
Bentzel-Sternau	Bentzel-Sternau	Bentzel-Sternau, Albert Graf	Bentzel-Sternau, Albert Graf
Benze	Benze	Benze, Wilhelm	Benze, Wilhelm
Berg, St.Petersb.	Berg	Berg, Ernst von (1824-x)	Berg, Ernst von
C.Berg	Berg	Berg, [Friedrich Wilhelm Carl, later Federico Guillermo] Carlos	Berg, Carlos
Eug.Berg	Berg	Berg, Eugen	Berg, Eugen
O.G.J.Berg	Berg	Berg, Otto Georg Julius	Berg, Otto Georg Julius
F.Berge	Berge	Berge, [Carl] Friedrich [Wilhelm]	Berge, Friedrich
H.Berge	Berge	Berge, Hermann	Berge, Hermann
H.Bergen	Bergen	Bergen, Heinrich von	Bergen, Heinrich von
Bergendal	Bergendal	Bergendal, David	Bergendal, David
Bergenthal	Bergenthal	Bergenthal, Wilhelm	Bergenthal, Wilhelm
L.G.den Berger	Berger	Berger, Louis Guillaume den	Berger, Louis Guillaume den
Bergevin	Bergevin	Bergevin, Ernest de	Bergevin, Ernest de
Berghaus	Berghaus	Berghaus, Heinrich Karl Wilhelm	Berghaus, Heinrich Karl Wilhelm
Berghuis	Berghuis	Berghuis, Samuel	Berghuis, Samuel
E.Bergman	Bergman	Bergman, Ernest	Bergman, Ernest
Bergroth	Bergroth	Bergroth, [Ivar] Ossian	Bergroth, Ossian
A.J.Bergsma	Bergsma	Bergsma, Arnold Jakob	Bergsma, Arnold Jakob
Bergsma	Bergsma	Bergsma, Cornelis Adriaan	Bergsma, Cornelis Adriaan
E.-L.Berher	Berher	Berher, Eugène-Laurent	Berher, Eugène-Laurent
Berkenhout	Berkenhout	Berkenhout, John	Berkenhout, John
Berkenkamp	Berkenkamp	Berkenkamp, W.A.	Berkenkamp, W.A.
Berkovec	Berkovec [Berkovcová]	Berkovec [Berkovcová], Anna	Berkovec, Anna
L.Berl.	Berlese	Berlese, Lorenzo Bernardo (Abate)	Berlese, Lorenzo Bernardo
A.Bernard	Bernard	Bernard, Alfred Carl Isaac	Bernard, Alfred Carl Isaac
G.Bernard	Bernard	Bernard, Georges [Eugène]	Bernard, Georges
Bernimolin	Bernimolin	Bernimolin, Henri	Bernimolin, Henri
M.Bernstein	Bernstein	Bernstein, Marie	Bernstein, Marie
Bernátzky	Bernátzsky	Bernátzsky, Jenö Emlékezette	Bernátzsky, Jenö Emlékezette
Berridge	Berridge	Berridge, Emily Mary	Berridge, Emily Mary
Berro	Berro	Berro, Mariano B.	Berro, Mariano B.
C.Berthold I	Berthold	Berthold, Carl [I]	Berthold, Carl
C.Berthold II	Berthold	Berthold, Carl [II]	Berthold, Carl
A.Bertol., Jr.	Bertoloni	Bertoloni, Antonio Jr.	Bertoloni, Antonio Jr.
P.C.E.Bertrand	Bertrand	Bertrand, Paul Charles Edouard	Bertrand, Paul Charles Edouard
Besnou	Besnou	Besnou, Léon	Besnou, Léon
J.F.Besser	Besser	Besser, Johannes Felix	Besser, Johannes Felix
Bethke	Bethke	Bethke, Albert	Bethke, Albert
Bettelini	Bettelini	Bettelini, Arnoldo	Bettelini, Arnoldo
Bettfreund	Bettfreund	Bettfreund, Karl [Carlos]	Bettfreund, Karl
Beust	Beust	Beust, Fritz von	Beust, Fritz von
J.F.Bevis	Bevis	Bevis, James Frederick	Bevis, James Frederick
H.R.Beyer	Beyer	Beyer, Harry Rudolf	Beyer, Harry Rudolf
Beyschlag	Beyschlag	Beyschlag, Franz Heinrich August	Beyschlag, Franz Heinrich August
Beyse	Beyse	Beyse, Gustav Hermann	Beyse, Gustav Hermann
Bhâradwâja	Bhâradwâja	Bhâradwâja, Yâjnyavalkya	Bhâradwâja, Yâjnyavalkya
Bidermann	Bidermann	Bidermann, Joseph	Bidermann, Joseph
Bilancioni	Bilancioni	Bilancioni, Guglielmo	Bilancioni, Guglielmo
Billerbeck	Billerbeck	Billerbeck, Julius Heinrich Ludwig	Billerbeck, Julius Heinrich Ludwig
Billing	Billing	Billing, Otto	Billing, Otto
F.H.Billings	Billings	Billings, Frederick Horatio	Billings, Frederick Horatio
W.D.Billings	Billings	Billings, William Dwight	Billings, William Dwight
M.T.Bingham	Bingham	Bingham, Marjorie T.	Bingham, Marjorie T.
Bioret	Bioret	Bioret, Georges Félix Marie	Bioret, Georges Félix Marie
Birge	Birge	Birge, Willie I.	Birge, Willie I.
Birger	Birger	Birger, Selim Birger Gotthard (né Andersson)	Birger, Selim Birger Gotthard
Birkenhead	Birkenhead	Birkenhead, John	Birkenhead, John
Birnie	Birnie	Birnie, Steven	Birnie, Steven
Birnstiel	Birnstiel	Birnstiel, Walter Rudolf	Birnstiel, Walter Rudolf
Bisceglie	Bisceglie	Bisceglie, Vito	Bisceglie, Vito
Bisschop	Bisschop van Tuinen	Bisschop van Tuinen, Klaas	Bisschop van Tuinen, Klaas
Björkenheim	Björkenheim	Björkenheim, Raf. [Edouard Rafael]	Björkenheim, Raf.
K.Björklund	Björklund	Björklund, Karin (Dorthe Johanna Katarina)	Björklund, Karin
G.Björkman	Björkman	Björkman, Gunnar	Björkman, Gunnar
Bjørnstr.	Bjørnström	Bjørnström, Fredrik Johan	Bjørnström, Fredrik Johan
Blaauw	Blaauw	Blaauw, Anton Hendrik	Blaauw, Anton Hendrik
K.B.Blackburn	Blackburn	Blackburn, Kathleen Bever	Blackburn, Kathleen Bever
Bladh.	Bladh	Bladh, Peter Johan	Bladh, Peter Johan
Blaese	Blaese	Blaese, Gustav Heinrich	Blaese, Gustav Heinrich
Louis Blanc	Blanc	Blanc, Louis	Blanc, Louis
Ch.Blanchet	Blanchet	Blanchet, Charles	Blanchet, Charles
Rod.Blanchet	Blanchet	Blanchet, Rodolphe	Blanchet, Rodolphe
F.Blank	Blank	Blank, Fritz	Blank, Fritz
P.Blasquez	Blasquez	Blasquez, Pedro	Blasquez, Pedro
J.Blau	Blau	Blau, Johannes	Blau, Johannes
O.Blau	Blau	Blau, [Ernst] Otto [Friedrich Hermann]	Blau, Otto
Blechingberg	Blechingberg	Blechingberg, William Andreas	Blechingberg, William Andreas
M.G.Bleicher	Bleicher	Bleicher, Marie Gustave	Bleicher, Marie Gustave
Bleier	Bleier	Bleier, Hubert	Bleier, Hubert
Blenk	Blenk	Blenk, Paul	Blenk, Paul
Blewitt	Blewitt	Blewitt, Arthur Edmond	Blewitt, Arthur Edmond
Bley (Brocken)	Bley	Bley, Franz (fl. 1896-1898)	Bley, Franz
F.Bley	Bley	Bley, Franz (1881-x)	Bley, Franz
Bliedner	Bliedner	Bliedner, Arno	Bliedner, Arno
O.Bloch	Bloch	Bloch, Oscar	Bloch, Oscar
Blocki	Blocki	Blocki, Bronislaw	Blocki, Bronislaw
Blodgett	Blodgett	Blodgett, Frederick Harvey	Blodgett, Frederick Harvey
Blodig	Blodig	Blodig, Carl. H.	Blodig, Carl. H.
C.A.Blomb.	Blomberg	Blomberg, Carl Albert	Blomberg, Carl Albert
A.G.Blomq.	Blomqvist	Blomqvist, Anton Gabriel	Blomqvist, Anton Gabriel
Bloomfield	Bloomfield	Bloomfield, Rev. Edwin Newson	Bloomfield, Rev. Edwin Newson
Blottner	Blottner	Blottner, Karl Ludwig	Blottner, Karl Ludwig
I.Blum	Blum	Blum, Isaak [J.]	Blum, Isaak
Blumenbach	Blumenbach	Blumenbach, Johann Friedrich	Blumenbach, Johann Friedrich
Blumenhain	Blumenhain	Blumenhain, Eugen Heinrich	Blumenhain, Eugen Heinrich
Blücher	Blücher	Blücher, H.	Blücher, H.
Bobilioff	Bobilioff-Preisser	Bobilioff-Preisser, Wassily	Bobilioff-Preisser, Wassily
Bobisut	Bobisut	Bobisut, O.	Bobisut, O.
Bochkoltz	Bochkoltz	Bochkoltz, W.C.	Bochkoltz, W.C.
Bochmann	Bochmann	Bochmann, Felix	Bochmann, Felix
R.Bock	Bock	Bock, Rudolf	Bock, Rudolf
Wilhelm Bock	Bock	Bock, Wilhelm	Bock, Wilhelm
Bocq.Lim.	Bocquillon-Limousin	Bocquillon-Limousin, Henri	Bocquillon-Limousin, Henri
F.Boden	Boden	Boden, Franz	Boden, Franz
Bodenbender	Bodenbender	Bodenbender, Wilhelm (Guillermo)	Bodenbender, Wilhelm
Bodmann	Bodmann	Bodmann, Helene	Bodmann, Helene
H.Bodmer	Bodmer	Bodmer, Helen	Bodmer, Helen
Boehm	Boehm	Boehm, Josef Anton	Boehm, Josef Anton
Boelman	Boelman	Boelman, Hensem Adriaan Cornelis	Boelman, Hensem Adriaan Cornelis
Boening	Boening	Boening, Richard	Boening, Richard
P.de Boer	Boer	Boer, Petrus de	Boer, Petrus de
R.H.Boerker	Boerker	Boerker, Richard Hans Douai	Boerker, Richard Hans Douai
Boeuf	Boeuf	Boeuf, F.	Boeuf, F.
M.Bogdanow	Bogdanow	Bogdanow, Modest [Nikolaevich]	Bogdanow, Modest
Bogue	Bogue	Bogue, Ernest Everett	Bogue, Ernest Everett
Bohny	Bohny	Bohny, Paul	Bohny, Paul
Boireau	Boireau	Boireau, Aurélien	Boireau, Aurélien
Bokorny	Bokorny	Bokorny, Thomas	Bokorny, Thomas
C.E.V.Boldt	Boldt	Boldt, Charles Emil Valentin	Boldt, Charles Emil Valentin
J.Boll	Boll	Boll, Jacob	Boll, Jacob
C.Bommer	Bommer	Bommer, Charles [Borromée Joseph Paul]	Bommer, Charles
R.W.Bond	Bond	Bond, Richard Wallace	Bond, Richard Wallace
Ch.Bonnet	Bonnet	Bonnet, Charles	Bonnet, Charles
Bonte	Bonte	Bonte, Ludwig	Bonte, Ludwig
Boon Mesch	Boon Mesch	Boon Mesch, Hendrik Carel van der	Boon Mesch, Hendrik Carel van der
Boorsma	Boorsma	Boorsma, Willem Gerbrand	Boorsma, Willem Gerbrand
Boosfeld	Boosfeld	Boosfeld, Albert	Boosfeld, Albert
Borchmann	Borchmann	Borchmann, [Johann] Friedrich	Borchmann, Friedrich
Bordiga	Bordiga	Bordiga, Benedetto	Bordiga, Benedetto
V.Borg	Borg	Borg, Väinö Gabriel [after 1906 K.G. Kivilinna]	Borg, Väinö Gabriel
Borgenstam	Borgenstam	Borgenstam, Elsa Henrietta	Borgenstam, Elsa Henrietta
Borggreve	Borggreve	Borggreve, Bernhard Robert August	Borggreve, Bernhard Robert August
Borgman	Borgman	Borgman, Johan Alfred	Borgman, Johan Alfred
E.Bormann	Bormann	Bormann, Erhard	Bormann, Erhard
J.Bormann	Bormann	Bormann, Johannes [Eberhard]	Bormann, Johannes
A.Born	Born	Born, Amandus Albert Oswald	Born, Amandus Albert Oswald
Bornebusch	Bornebusch	Bornebusch, [Aage] Carl Heinrich	Bornebusch, Carl Heinrich
F.Bornemann	Bornemann	Bornemann, Felix	Bornemann, Felix
J.Bornem.	Bornemann	Bornemann, Johann Georg	Bornemann, Johann Georg
Borzi	Borzi	Borzi, Antonino	Borzi, Antonino
G.C.Bose	Bose	Bose, G.C.	Bose, G.C.
Bossh.	Bosshard	Bosshard, Walter	Bosshard, Walter
Bossin	Bossin	Bossin, Matthieu	Bossin, Matthieu
Bossler	Bossler	Bossler, Ludwig	Bossler, Ludwig
Bossu	Bossu	Bossu, Antonin François	Bossu, Antonin François
Boubier	Boubier	Boubier, Alphonse Maurice	Boubier, Alphonse Maurice
Bouillat	Bouillat	Bouillat, Maurice E.	Bouillat, Maurice E.
Bouillenne	Bouillenne	Bouillenne, Raymond	Bouillenne, Raymond
Bouisson	Bouisson	Bouisson, A. Gustave	Bouisson, A. Gustave
R.Bourdon	Bourdon	Bourdon, Raoul	Bourdon, Raoul
Bourguignat	Bourguignat	Bourguignat, Jules-René	Bourguignat, Jules-René
Bouveyron	Bouveyron	Bouveyron, L.	Bouveyron, L.
Boué	Boué	Boué, Ami	Boué, Ami
Bowerbank	Bowerbank	Bowerbank, James Scott	Bowerbank, James Scott
P.W.Bowman	Bowman	Bowman, Paul William	Bowman, Paul William
Boxus	Boxus	Boxus, Robert	Boxus, Robert
Boye	Boye	Boye, P.	Boye, P.
Ge.Boyer	Boyer	Boyer, Georges	Boyer, Georges
Braccif.	Bracciforti	Bracciforti, Alberto (Conte)	Bracciforti, Alberto
Braemer	Braemer	Braemer, Louis	Braemer, Louis
Braendlein	Braendlein	Braendlein, Karl	Braendlein, Karl
C.K.Brain	Brain	Brain, Charles K.	Brain, Charles K.
Don.Brand	Brand	Brand, Donald	Brand, Donald
J.Brandl	Brandl	Brandl, Joseph	Brandl, Joseph
Brandsch	Brandsch	Brandsch, Carl	Brandsch, Carl
Brandstetter	Brandstetter	Brandstetter, Josef Leopold	Brandstetter, Josef Leopold
A.Brandt	Brandt	Brandt, Alfred	Brandt, Alfred
E.F.W.Brandt	Brandt	Brandt, Ernst Friedrich Wilhelm	Brandt, Ernst Friedrich Wilhelm
R.P.Brandt	Brandt	Brandt, Robert Percy	Brandt, Robert Percy
Brandts Buys	Brandts Buys	Brandts Buys, L.F.R.P.C.A.	Brandts Buys, L.F.R.P.C.A.
Brannon	Brannon	Brannon, Melvin Amos	Brannon, Melvin Amos
Branscheidt	Branscheidt	Branscheidt, Paul	Branscheidt, Paul
A.Bras	Bras	Bras, Antoine	Bras, Antoine
Brass	Brass	Brass, Leonard John	Brass, Leonard John
C.P.Braun	Braun	Braun, Carl Philipp Johann Georg	Braun, Carl Philipp Johann Georg
E.Braun	Braun	Braun, Ernst	Braun, Ernst
Lucy Braun	Braun	Braun, [Emma] Lucy	Braun, Lucy
W.Braun	Braun	Braun, Waldemar	Braun, Waldemar
F.Braune	Braune	Braune, Franz Anton Alexander von	Braune, Franz Anton Alexander von
L.Bravais	Bravais	Bravais, Louis François	Bravais, Louis François
Breakwell	Breakwell	Breakwell, Ernest	Breakwell, Ernest
Brebner	Brebner	Brebner, George	Brebner, George
Breidenstein	Breidenstein	Breidenstein, W.	Breidenstein, W.
A.Breitf.	Breitfeld	Breitfeld, Alexander	Breitfeld, Alexander
Brenchley	Brenchley	Brenchley, Winifred Elsie	Brenchley, Winifred Elsie
Brendel	Brendel	Brendel, Frederik	Brendel, Frederik
Wid.Brenner	Brenner	Brenner, Widar [Magnus]	Brenner, Widar
A.Breton	Breton	Breton, André le	Breton, André le
C.Breton	Breton	Breton, C.	Breton, C.
H.Bretzl	Bretzl	Bretzl, Hugo	Bretzl, Hugo
Breut.	Breutel	Breutel, Johann Christian	Breutel, Johann Christian
Brez	Brez	Brez, Jacques	Brez, Jacques
Brierley	Brierley	Brierley, William Broadhurst	Brierley, William Broadhurst
V.Briganti	Briganti	Briganti, Vincenzo	Briganti, Vincenzo
O.Brill	Brill	Brill, Otto	Brill, Otto
Briss.	Brisson de Lenharrée	Brisson de Lenharrée, Théodore Polycarpe	Brisson de Lenharrée, Théodore Polycarpe
Brockhausen	Brockhausen	Brockhausen, H.	Brockhausen, H.
Brodtmann	Brodtmann	Brodtmann, [Carl Johann Albert] Fritz	Brodtmann, Fritz
Broekens	Broekens	Broekens, Douwe Johannes	Broekens, Douwe Johannes
Broekhuizen	Broekhuizen	Broekhuizen, S.	Broekhuizen, S.
Broeksmit	Broeksmit	Broeksmit, Teunís	Broeksmit, Teunís
Broers	Broers	Broers, Georg	Broers, Georg
Brokschmidt	Brokschmidt	Brokschmidt, [Philipp August] Otto	Brokschmidt, Otto
Brough	Brough	Brough, Patrick	Brough, Patrick
J.Brouwer	Brouwer	Brouwer, Jacoba	Brouwer, Jacoba
H.P.Br.	Brown	Brown, Harry Philip	Brown, Harry Philip
J.E.Brown	Brown	Brown, John Ednie	Brown, John Ednie
J.P.Br.	Brown	Brown, J. P.	Brown, J. P.
M.R.Br.	Brown	Brown, M. R.	Brown, M. R.
O.T.Br.	Brown	Brown, Olof Theodor	Brown, Olof Theodor
S.Brown	Brown	Brown, Stewardson	Brown, Stewardson
I.Browne	Browne	Browne, [Lady] Isabel Mary Peyronnet	Browne, Isabel Mary Peyronnet
Brož	Brož	Brož, Otto	Brož, Otto
C.L.Bruch	Bruch	Bruch, Carl [Karl] Ludwig	Bruch, Carl Ludwig
Bruchm.	Bruchmann	Bruchmann, Helmut	Bruchmann, Helmut
Bruck	Bruck	Bruck, Werner Friedrich	Bruck, Werner Friedrich
Bruckmüller	Bruckmüller	Bruckmüller, A.	Bruckmüller, A.
Bruggeman	Bruggeman	Bruggeman, Marie Louis Abraham	Bruggeman, Marie Louis Abraham
V.Bruinsma	Bruinsma	Bruinsma, Vitus	Bruinsma, Vitus
Brundin	Brundin	Brundin, Johan Alfred Zakarias	Brundin, Johan Alfred Zakarias
Brundza	Brundza	Brundza, K.	Brundza, K.
Brunies	Brunies	Brunies, Stephan Ernst	Brunies, Stephan Ernst
C.Brunner fils	Brunner	Brunner, C. fils	Brunner, C. fils
C.Brunner, Hamb.	Brunner	Brunner, Carl (of Hamburg)	Brunner, Carl
Brunotte	Brunotte	Brunotte, Camille-Marie-Gabriel	Brunotte, Camille-Marie-Gabriel
Brunswik	Brunswik [Brunswick] von Korompa	Brunswik [Brunswick] von Korompa, Hermann	Brunswik von Korompa, Hermann
Bruz	Bruz	Bruz, Ladislai [Ludwig]	Bruz, Ladislai
Bry	Bry	Bry, Heinz Max [Eduard]	Bry, Heinz Max
W.A.Bryan	Bryan	Bryan, William Alanson	Bryan, William Alanson
M.Brândzǎ	Brândza	Brândză, Marcel Alex	Brândză, Marcel Alex
Bubel	Bubel	Bubel, Karl Christian	Bubel, Karl Christian
O.Buch	Buch	Buch, Otto	Buch, Otto
J.Buchanan, C.M.G.	Buchanan	Buchanan, John, Rev. C.M.G.	Buchanan, John, Rev. C.M.G.
C.T.Bucher	Bucher	Bucher, Christian Traugott	Bucher, Christian Traugott
Bucherer	Bucherer	Bucherer, Emil [Bucherer-Gölz]	Bucherer, Emil
M.Buchli	Buchli	Buchli, Matheus	Buchli, Matheus
Buchholz	Bucholtz [Buchholz]	Bucholtz [Buchholz], Fedor [Vladimirovič]	Bucholtz, Fedor
Buchoz	Buchoz	Buchoz, Pierre Joseph	Buchoz, Pierre Joseph
J.W.Budde	Budde	Budde, [Johannes] Wilhelm	Budde, Wilhelm
Buekers	Buekers	Buekers, P. G.	Buekers, P. G.
Bugnon	Bugnon	Bugnon, Pierre Frédéric	Bugnon, Pierre Frédéric
Bujack	Bujack	Bujack, Johann Gottlieb	Bujack, Johann Gottlieb
Ém.Bureau	Bureau	Bureau, Émile	Bureau, Émile
Burgerstein	Burgerstein	Burgerstein, Alfred	Burgerstein, Alfred
J.J.Burgess	Burgess	Burgess, James John	Burgess, James John
J.T.Burgess	Burgess	Burgess, Joseph Tom	Burgess, Joseph Tom
T.Burgess	Burgess	Burgess, Thomas Joseph Workman	Burgess, Thomas Joseph Workman
K.Burk	Burk	Burk, Karl	Burk, Karl
P.R.Burkh.	Burkholder	Burkholder, Paul Rufus	Burkholder, Paul Rufus
Burlingame	Burlingame	Burlingame, Leonas Lancelot	Burlingame, Leonas Lancelot
J.Burm.	Burman	Burman, Johannes	Burman, Johannes
Burmeister	Burmeister [of Grünberg	Burmeister [of Grünberg, given names not known]	Burmeister
M.A.Burnett	Burnett	Burnett, Miss M.A.	Burnett, Miss M.A.
G.P.Burns	Burns	Burns, Georg Plumer	Burns, Georg Plumer
W.Burns	Burns	Burns, William	Burns, William
Burtin	Burtin	Burtin, François Xavier de	Burtin, François Xavier de
A.H.Burtt	Burtt	Burtt, Arthur H.	Burtt, Arthur H.
P.Busch	Busch	Busch, Paul	Busch, Paul
Buschbaum	Buschbaum	Buschbaum, Heinrich	Buschbaum, Heinrich
Buschmann	Buschmann	Buschmann, Adolphine	Buschmann, Adolphine
A.Busse	Busse	Busse, Arnold	Busse, Arnold
Bute	Bute	Bute, John Stuart, 3rd earl of	Bute, John Stuart, 3rd earl of
G.D.Butler	Butler	Butler, George Dexter	Butler, George Dexter
J.Butterworth	Butterworth	Butterworth, John	Butterworth, John
Bálmis	Bálmis	Bálmis, Francisco Xavier [de]	Bálmis, Francisco Xavier
J.Bär	Bär	Bär, Johannes	Bär, Johannes
Bäsecke	Bäsecke	Bäsecke, [Karl Heinrich Johannes] Paul	Bäsecke, Paul
Bäuml.	Bäumler	Bäumler, Johann Andreas	Bäumler, Johann Andreas
Bégué	Bégué	Bégué, Louis Henri	Bégué, Louis Henri
Boeck.	Böckeler [Boeckeler]	Böckeler [Boeckeler], [Johann] Otto	Böckeler, Otto
Böninger	Böninger	Böninger, Theodor Conrad	Böninger, Theodor Conrad
Bötticher	Bötticher	Bötticher, Friedrich Robert Wilhelm [Willy]	Bötticher, Friedrich Robert Wilhelm
E.Büchner	Büchner	Büchner, Eduard Wilhelm Gottlieb	Büchner, Eduard Wilhelm Gottlieb
Bürkle	Bürkle	Bürkle, Richard	Bürkle, Richard
Cacciamali	Cacciamali	Cacciamali, Gio Battista	Cacciamali, Gio Battista
Cadet de Gass.	Cadet de Gassicourt	Cadet de Gassicourt, Charles Louis Félix	Cadet de Gassicourt, Charles Louis Félix
J.Cahn	Cahn	Cahn, Jakob	Cahn, Jakob
R.Cahn	Cahn	Cahn, Regina	Cahn, Regina
Caius	Caius	Caius, Jean Ferdinand	Caius, Jean Ferdinand
O.Cajander	Cajander (Kalela)	Cajander (Kalela), Olawi (Eino Antero Olawi)	Cajander, Olawi
Cake	Cake	Cake, Wallace Ellwood	Cake, Wallace Ellwood
Calcara	Calcara	Calcara, Pietro	Calcara, Pietro
C.C.Calder	Calder	Calder, Charles Cumming	Calder, Charles Cumming
S.Calderon	Calderon	Calderon, Salvador	Calderon, Salvador
O.W.Caldwell	Caldwell	Caldwell, Otis William	Caldwell, Otis William
Calkoen	Calkoen Az.	Calkoen Az., Hendrik Joän	Calkoen Az., Hendrik Joän
R.E.Call	Call	Call, Richard Ellsworth	Call, Richard Ellsworth
Callmé	Callmé	Callmé, Herman Alfred	Callmé, Herman Alfred
Calvi	Calvi	Calvi, Giovanni	Calvi, Giovanni
CamaraLeme	Camara-Leme	Camara-Leme, João da	Camara-Leme, João da
D.R.Cameron	Cameron	Cameron, Donald Ross	Cameron, Donald Ross
J.Cameron Sund.	Cameron	Cameron, John (Sunderland)	Cameron, John
Cammerloher	Cammerloher	Cammerloher, Hermann	Cammerloher, Hermann
A.F.Camp	Camp	Camp, Arthur Forrest	Camp, Arthur Forrest
Campanile	Campanile	Campanile, Giulia	Campanile, Giulia
E.G.Campb.	Campbell	Campbell, [Dean] Elmer Grant	Campbell, Elmer Grant
R.S.Campb.	Campbell	Campbell, Robert Samuel	Campbell, Robert Samuel
Rob.Campb.	Campbell	Campbell, Robert	Campbell, Robert
Campos-Porto	Campos Porto	Campos Porto, Paulo de	Campos Porto, Paulo de
F.Camus	Camus	Camus, Fernand [Antonin]	Camus, Fernand
J.Camus	Camus	Camus, Jules [Giulio]	Camus, Jules
Canabaeus	Canabaeus	Canabaeus, Lotte	Canabaeus, Lotte
C.-A.Candargy	Candargy	Candargy, C.-A. [Antoin]	Candargy, C.-A.
P.C.Candargy	Candargy	Candargy, Paléologos C.	Candargy, Paléologos C.
Candrian	Candrian	Candrian, Moritz [Murezzan]	Candrian, Moritz
Cannarella	Cannarella	Cannarella, Pietro	Cannarella, Pietro
W.A.Cannon	Cannon	Cannon, William Austin	Cannon, William Austin
Cantieny	Cantieny	Cantieny, G.	Cantieny, G.
Cap	Cap	Cap, Paul-Antoine, called Gratacap	Cap, Paul-Antoine, called Gratacap
Capelle-Springe	Capelle-Springe	Capelle-Springe, G.	Capelle-Springe, G.
Capitaine	Capitaine	Capitaine, Louis	Capitaine, Louis
Cappel	Cappel	Cappel, Johann Friedrich Ludwig	Cappel, Johann Friedrich Ludwig
Cappelletti	Cappelletti	Cappelletti, Carlo	Cappelletti, Carlo
G.Capra	Capra	Capra, Giuseppe	Capra, Giuseppe
Capus	Capus	Capus, [Jean] Guillaume	Capus, Guillaume
Caquet	Caquet	Caquet, François	Caquet, François
Cara	Cara	Cara, Alberto	Cara, Alberto
Caraven-Cachin	Caraven-Cachin	Caraven-Cachin, Alfred	Caraven-Cachin, Alfred
Cardiff	Cardiff	Cardiff, Ira Dietrich	Cardiff, Ira Dietrich
Cardoso Jr.	Cardoso [Junior]	Cardoso [Junior], João [Antonio]	Cardoso, João
Carena	Carena	Carena, Giacinto	Carena, Giacinto
Ant.Carestia	Carestia	Carestia, Antonio	Carestia, Antonio
W.Carey	Carey	Carey, William	Carey, William
H.Carl	Carl	Carl, Helmut	Carl, Helmut
J.A.Carl	Carl	Carl, Joseph Anton	Carl, Joseph Anton
Carles	Carles	Carles, Pierre-Paulin	Carles, Pierre-Paulin
Carlet	Carlet	Carlet, Joseph Gaston	Carlet, Joseph Gaston
C.S.Carlson	Carlson	Carlson, C. S.	Carlson, C. S.
Carmignani	Carmignani	Carmignani, Vincenzo	Carmignani, Vincenzo
H.Caro	Caro	Caro, Hugo	Caro, Hugo
Carpenter	Carpenter	Carpenter, William	Carpenter, William
W.B.Carpenter	Carpenter	Carpenter, William Benjamin	Carpenter, William Benjamin
Ad.Carpentier	Carpentier	Carpentier, Adolphe	Carpentier, Adolphe
L.Carrier	Carrier	Carrier, Lyman	Carrier, Lyman
G.Carron	Carron	Carron, Gustave	Carron, Gustave
H.G.Carter	Carter	Carter, Humphrey Gilbert	Carter, Humphrey Gilbert
J.M.Carter	Carter	Carter, James Madison Gore	Carter, James Madison Gore
W.Carter	Carter	Carter, William R.	Carter, William R.
Cas.-Gil	Casares-Gil	Casares-Gil, Antonio	Casares-Gil, Antonio
P.Caspari	Caspari	Caspari, Paul	Caspari, Paul
Casparis	Casparis	Casparis, Paul	Casparis, Paul
Castellanos	Castellanos	Castellanos, Alberto	Castellanos, Alberto
L.Castillo	Castillo	Castillo, Luis	Castillo, Luis
Castillon	Castillon	Castillon, Léon	Castillon, Léon
H.Castle	Castle	Castle, Hempstead	Castle, Hempstead
Th.Castle	Castle	Castle, Thomas	Castle, Thomas
Castracane	Castracane degli Antelminelli	Castracane degli Antelminelli, Francesco	Castracane degli Antelminelli, Francesco
Catcheside	Catcheside	Catcheside, David Guthrie	Catcheside, David Guthrie
Cattaneo	Cattaneo	Cattaneo, Antonio	Cattaneo, Antonio
W.Cattley	Cattley	Cattley, William	Cattley, William
Caussin	Caussin	Caussin, Octave Arthur	Caussin, Octave Arthur
G.Cave	Cave	Cave, George H.	Cave, George H.
Cayley	Cayley	Cayley, Dorothy Mary	Cayley, Dorothy Mary
A.C.P.Caylus, Jr.	Caylus	Caylus, Anne Claude Philippe..., Comte [Jr.]	Caylus, Anne Claude Philippe, Comte
A.C.P.Caylus, Sr.	Caylus	Caylus, Anne Claude Philippe..., Comte de	Caylus, Anne Claude Philippe, Comte de
Cazalas	Cazalas	Cazalas, Robert	Cazalas, Robert
C.-E.Cazin	Cazin	Cazin, C. E.	Cazin, C. E.
F.J.Cazin	Cazin	Cazin, F. J.	Cazin, F. J.
Cederv.	Cedervall	Cedervall, Edvard Vilhelm	Cedervall, Edvard Vilhelm
Ceillier	Ceillier	Ceillier, René	Ceillier, René
Cerio	Cerio	Cerio, Ignazio	Cerio, Ignazio
Cermenati	Cermenati	Cermenati, Mario	Cermenati, Mario
Chabrolin	Chabrolin	Chabrolin, Charles	Chabrolin, Charles
É.Chaix	Chaix	Chaix, Émile	Chaix, Émile
J.Chalmers	Chalmers	Chalmers, James	Chalmers, James
E.Chaloner	Chaloner	Chaloner, Edward	Chaloner, Edward
J.S.Chamb.	Chamberlain	Chamberlain, Joseph Scudder	Chamberlain, Joseph Scudder
Chantelat	Chantelat	Chantelat, A.E.	Chantelat, A.E.
Chanter	Chanter	Chanter, [Mrs.] Charlotte (née Kingsley)	Chanter, Charlotte
F.Chapman	Chapman	Chapman, Frederick	Chapman, Frederick
Charguéraud	Charguéraud	Charguéraud, Charles Gilbert André	Charguéraud, Charles Gilbert André
Charla	Charla	Charla	Charla
G.M.Charles	Charles	Charles, Grace Miriam	Charles, Grace Miriam
Charlier	Charlier	Charlier, Carl Vilhelm Ludvig	Charlier, Carl Vilhelm Ludvig
Charpentier	Charpentier	Charpentier, Jean G. F. de	Charpentier, Jean G. F. de
Charrier	Charrier	Charrier, Joseph	Charrier, Joseph
Charropin	Charropin	Charropin, Georges	Charropin, Georges
P.Charropin	Charropin	Charropin, Paul	Charropin, Paul
Chartier	Chartier	Chartier, Henri	Chartier, Henri
Chastaingt	Chastaingt	Chastaingt, Gabriel (Pierre Joseph Victor Gabriel)	Chastaingt, Gabriel
E.Chateau	Chateau	Chateau, Émile	Chateau, Émile
R.Chatel	Chatel	Chatel, Rémy	Chatel, Rémy
J.Chatin	Chatin	Chatin, Joannes Charles Melchior	Chatin, Joannes Charles Melchior
Chauveaud	Chauveaud	Chauveaud, [Louis] Gustave	Chauveaud, Gustave
Chavannes	Chavannes	Chavannes, Èdouard Louis	Chavannes, Èdouard Louis
Chaze	Chaze	Chaze, Jean	Chaze, Jean
W.N.Cheesman	Cheesman	Cheesman, William Norwood	Cheesman, William Norwood
Chesnon	Chesnon	Chesnon, Charles Georges	Chesnon, Charles Georges
Chesnut	Chesnut	Chesnut, Victor King	Chesnut, Victor King
K.S.Chester	Chester	Chester, Kenneth Starr	Chester, Kenneth Starr
Chibber	Chibber	Chibber, Hormasji Maneckji	Chibber, Hormasji Maneckji
Th.W.Childs	Childs	Childs, Thomas White	Childs, Thomas White
Chimani	Chimani	Chimani, Otto	Chimani, Otto
Chipman	Chipman	Chipman, Marshall Mead	Chipman, Marshall Mead
R.H.Chipman	Chipman	Chipman, Ruth Harriet (née Hayes)	Chipman, Ruth Harriet
Chirat	Chirat du Vernay	Chirat du Vernay, Ludovic Charles Antoine	Chirat du Vernay, Ludovic Charles Antoine
R.J.Chitt.	Chittenden	Chittenden, Reginald John	Chittenden, Reginald John
Chitty	Chitty	Chitty, Edward	Chitty, Edward
Chomette	Chomette	Chomette, A.	Chomette, A.
Choulette	Choulette	Choulette, Sébastien	Choulette, Sébastien
K.Christ	Christ	Christ, Karl	Christ, Karl
Alb.Christ.	Christiansen	Christiansen, Albertus	Christiansen, Albertus
W.Christ.	Christiansen	Christiansen, Werner Friedrich	Christiansen, Werner Friedrich
Christman	Christman	Christman, A.H.	Christman, A.H.
J.R.Churchill	Churchill	Churchill, Joseph Richmond	Churchill, Joseph Richmond
Cicioni	Cicioni	Cicioni, Giulio	Cicioni, Giulio
Cieslar	Cieslar	Cieslar, Adolf	Cieslar, Adolf
Cihlar	Cihlar	Cihlar, Cvijeta	Cihlar, Cvijeta
Cilleuls	Cilleuls	Cilleuls, J. des	Cilleuls, J. des
Arckenhausen	Ckenhausen	Akenhausen, Johann Christian Peter	Akenhausen, Johann Christian Peter
Claparède	Claparède	Claparède, Jean Louis René Antoine Édouard	Claparède, Jean Louis René Antoine Édouard
A.Clapp	Clapp	Clapp, Asahel	Clapp, Asahel
Cl.Clark	Clark	Clark, Clarissa	Clark, Clarissa
G.Clark	Clark	Clark, Galen	Clark, Galen
G.H.Clark	Clark	Clark, George Harold	Clark, George Harold
J.Clark	Clark	Clark, Joseph	Clark, Joseph
W.S.Clark	Clark	Clark, William Smith	Clark, William Smith
A.E.Clarke	Clarke	Clarke, Alfred Ernest	Clarke, Alfred Ernest
L.L.Clarke	Clarke	Clarke, Louisa Lane [née Lane]	Clarke, Louisa Lane
S.Clarke	Clarke	Clarke, Stephen	Clarke, Stephen
Clason	Clason	Clason, Else Willem	Clason, Else Willem
H.M.Claudel	Claudel	Claudel, Henri-Marie	Claudel, Henri-Marie
C.Claus	Claus	Claus, Carl [Friedrich Wilhelm]	Claus, Carl
Clautriau	Clautriau	Clautriau, Georges	Clautriau, Georges
Clawson	Clawson	Clawson, Arthur Brooks	Clawson, Arthur Brooks
Clee	Clee	Clee, David A.	Clee, David A.
J.B.Clifford	Clifford	Clifford, Julia Blanche	Clifford, Julia Blanche
M.H.Clifford	Clifford	Clifford, Montagu Howard	Clifford, Montagu Howard
Clinton-Baker	Clinton-Baker	Clinton-Baker, Henri William	Clinton-Baker, Henri William
Cluysenaar	Cluysenaar	Cluysenaar, P.-G.	Cluysenaar, P.-G.
Cléonique-Joseph	Cléonique-Joseph	Cléonique-Joseph, Frère (Julian Bablee)	Cléonique-Joseph, Frère
R.Cobelli	Cobelli	Cobelli, Ruggero	Cobelli, Ruggero
R.W.S.Cocks	Cocks	Cocks, Reginald Wodehouse Somers	Cocks, Reginald Wodehouse Somers
Coester	Coester	Coester, Carl	Coester, Carl
Cohen Stuart	Cohen Stuart	Cohen Stuart, Combertus Pieter	Cohen Stuart, Combertus Pieter
G.Cohn	Cohn	Cohn, Georg	Cohn, Georg
Coldstream	Coldstream	Coldstream, William	Coldstream, William
Emma Cole	Cole	Cole, Emma J.	Cole, Emma J.
F.Collard	Collard	Collard, François	Collard, François
E.Collin	Collin	Collin, Eugène Jean Baptiste	Collin, Eugène Jean Baptiste
Colling	Colling	Colling, Jakob Ferdinand	Colling, Jakob Ferdinand
J.F.Collins	Collins	Collins, James Franklin	Collins, James Franklin
M.I.Collins	Collins	Collins, Marjorie Isabel	Collins, Marjorie Isabel
Colm.	Colmeiro y Penido	Colmeiro y Penido, Don Miguel	Colmeiro y Penido, Don Miguel
Colomb-Duplan	Colomb-Duplan	Colomb-Duplan, G.	Colomb-Duplan, G.
Colson	Colson	Colson, Barbara	Colson, Barbara
Combes	Combes	Combes, Jacques-Ludomir	Combes, Jacques-Ludomir
Commerson	Commerson	Commerson, Philibert	Commerson, Philibert
Companyo	Companyo [-Lanquine]	Companyo [-Lanquine], Jean [Baudile] Louis	Companyo, Jean Louis
Compter	Compter	Compter, Gustav	Compter, Gustav
Comstock	Comstock	Comstock, John Lee	Comstock, John Lee
A.X.J.Conard	Conard	Conard, Alexandre Xavier Justin	Conard, Alexandre Xavier Justin
Concina	Concina	Concina, Nicoleto [Nicoló]	Concina, Nicoleto
I.J.Condit	Condit	Condit, Ira Judson	Condit, Ira Judson
Coninck	Coninck	Coninck, Louis Charles Frederik de	Coninck, Louis Charles Frederik de
A.Constantin	Constantin	Constantin, Aimé	Constantin, Aimé
P.Constantin	Constantin	Constantin, Paul	Constantin, Paul
V.M.Conway	Conway	Conway, Verona Margaret [Miss]	Conway, Verona Margaret
A.Cook	Cook	Cook, Alice (née Carter)	Cook, Alice
J.Cook	Cook	Cook, James	Cook, James
P.L.Cook	Cook	Cook, Phyllis Lucy	Cook, Phyllis Lucy
G.E.Cooley	Cooley	Cooley, Grace Emily	Cooley, Grace Emily
J.C.Cooley	Cooley	Cooley, Jacquelin Smith	Cooley, Jacquelin Smith
L.M.Cooley	Cooley	Cooley, Luster Manring	Cooley, Luster Manring
Coomans	Coomans de Ruiter	Coomans de Ruiter, Louis	Coomans de Ruiter, Louis
C.S.Cooper	Cooper	Cooper, Charles Samuel	Cooper, Charles Samuel
R.Copel.	Copeland	Copeland, Ralph	Copeland, Ralph
Copineau	Copineau	Copineau, Charles	Copineau, Charles
Corbett	Corbett	Corbett, Lee Cleveland	Corbett, Lee Cleveland
Corboz	Corboz	Corboz, François	Corboz, François
I.Cordem.	Cordemoy	Cordemoy, Mlle I. de	Cordemoy, Mlle I. de
L.Cordero	Cordero	Cordero, Luis	Cordero, Luis
J.W.H.Cordes	Cordes	Cordes, Jan Willem Hugo	Cordes, Jan Willem Hugo
Cordienne	Cordienne	Cordienne, Alexis-Joseph	Cordienne, Alexis-Joseph
Cornevin	Cornevin	Cornevin, Charles Ernest	Cornevin, Charles Ernest
P.Cornu	Cornu	Cornu, Pierre	Cornu, Pierre
Corr.Méllo	Correia [Correa] de Méllo	Correia [Correa] de Méllo, Joaquim	Correia de Méllo, Joaquim
R.Cortesi	Cortesi	Cortesi, Rodolphe	Cortesi, Rodolphe
A.Corti	Corti	Corti, Alfredo	Corti, Alfredo
B.Corti	Corti	Corti, Benedetto	Corti, Benedetto
E.Corti	Corti	Corti, Egidio	Corti, Egidio
Ch.Coster	Coster	Coster, Charles	Coster, Charles
D.J.Coster	Coster	Coster, David Jacob	Coster, David Jacob
Costerus	Costerus	Costerus, Jan Constantijn	Costerus, Jan Constantijn
H.Cotta	Cotta	Cotta, Heinrich	Cotta, Heinrich
R.U.Cotter	Cotter	Cotter, Ralph Ulysses	Cotter, Ralph Ulysses
Cottle	Cottle	Cottle, Harvey James	Cottle, Harvey James
J.G.S.Cotton	Cotton	Cotton, Joseph Gustav Stanislas	Cotton, Joseph Gustav Stanislas
Coudenberg	Coudenberg	Coudenberg, Peter	Coudenberg, Peter
Couffinhal	Couffinhal	Couffinhal, M.	Couffinhal, M.
Coulouma	Coulouma	Coulouma, Joseph	Coulouma, Joseph
Coultas	Coultas	Coultas, Harland	Coultas, Harland
S.Coult.	Coulter	Coulter, [Moses] Stanley	Coulter, Stanley
S.E.M.Coult.	Coulter	Coulter, Samuel Elderslie Monds	Coulter, Samuel Elderslie Monds
Couret-Villeneuve	Couret-Villeneuve	Couret-Villeneuve, Louis Pierre	Couret-Villeneuve, Louis Pierre
Coutance	Coutance	Coutance, Amédée Guillaume Auguste	Coutance, Amédée Guillaume Auguste
Couverchel	Couverchel	Couverchel, Jean François	Couverchel, Jean François
E.M.Coventry	Coventry	Coventry, E. M.	Coventry, E. M.
K.H.Coward	Coward	Coward, Katherine Hope	Coward, Katherine Hope
C.F.Cox	Cox	Cox, Charles Finney	Cox, Charles Finney
J.D.Cox	Cox	Cox, Jacob Dolson	Cox, Jacob Dolson
J.R.Coxe	Coxe	Coxe, John Redman	Coxe, John Redman
Coxhead	Coxhead	Coxhead, Henry	Coxhead, Henry
Coyault	Coyault	Coyault, Marie-Emmanuel-Victor	Coyault, Marie-Emmanuel-Victor
M.Craig	Craig	Craig, Moses	Craig, Moses
J.Cramer	Cramer	Cramer, Johann Christian	Cramer, Johann Christian
W.C.P.Cramer	Cramer	Cramer, Wilhelm Christian Philipp	Cramer, Wilhelm Christian Philipp
C.B.Crampton	Crampton	Crampton, Cecil Burleigh	Crampton, Cecil Burleigh
M.D.Cran	Cran	Cran, Marion Dudley	Cran, Marion Dudley
C.S.Crand.	Crandall	Crandall, Charles Spencer	Crandall, Charles Spencer
F.Crane	Crane	Crane, Florence (née Hedleston)	Crane, Florence
M.B.Crane	Crane	Crane, Morley Benjamin	Crane, Morley Benjamin
A.C.Crawford	Crawford	Crawford, Albert Cornelius	Crawford, Albert Cornelius
D.L.Crawford	Crawford	Crawford, David Livingston	Crawford, David Livingston
F.C.Crawford	Crawford	Crawford, Francis Chalmers	Crawford, Francis Chalmers
J.Crawford	Crawford	Crawford, Joseph	Crawford, Joseph
Creevey	Creevey	Creevey, Caroline Alathea (neé Stickney)	Creevey, Caroline Alathea
Crespi	Crespi	Crespi, Jaime Luis	Crespi, Jaime Luis
H.B.Croom	Croom	Croom, Hardy Bryan	Croom, Hardy Bryan
C.M.Crosby	Crosby	Crosby, Caroline Macomber	Crosby, Caroline Macomber
W.F.Crosier	Crosier	Crosier, Willard Francis	Crosier, Willard Francis
Crowfoot	Crowfoot	Crowfoot, Grace Mary (Hood)	Crowfoot, Grace Mary
É.Cruchet	Cruchet	Cruchet, Émilie	Cruchet, Émilie
Crugnola	Crugnola	Crugnola, Gaetano	Crugnola, Gaetano
Cubières	Cubières	Cubières, Simon Louis Pierre de (Marquis)	Cubières, Simon Louis Pierre de
Culemann	Culemann	Culemann, Helgo W.	Culemann, Helgo W.
Cultrera	Cultrera	Cultrera, Paolo de	Cultrera, Paolo de
A.Cuny	Cuny	Cuny, A.	Cuny, A.
M.E.Currie	Currie	Currie, Mary Elisabeth	Currie, Mary Elisabeth
Ch.Curtis	Curtis	Curtis, Charles	Curtis, Charles
J.Cushing	Cushing	Cushing, John	Cushing, John
W.C.Cusick	Cusick	Cusick, William Conklin	Cusick, William Conklin
M.Cutler	Cutler	Cutler, Manasseh	Cutler, Manasseh
E.M.Cutting	Cutting	Cutting, Ernest Melville	Cutting, Ernest Melville
Cuzent	Cuzent	Cuzent, Gilbert Henri	Cuzent, Gilbert Henri
Cuénot	Cuénot	Cuénot, Lucien Claude Marie Julien	Cuénot, Lucien Claude Marie Julien
Cyge	Cyge[Cygowa]	Cyge[Cygowa], Tekla	Cyge, Tekla
Czaja	Czaja	Czaja, Alphons Theodor	Czaja, Alphons Theodor
Czapek	Czapek	Czapek, Friedrich Johan Franz	Czapek, Friedrich Johan Franz
Czartkowski	Czartkowski	Czartkowski, Adam	Czartkowski, Adam
Czyrsnic.	Czyrsnicówna	Czyrsnicówna, Marja	Czyrsnicówna, Marja
Cürie	Cürie	Cürie, Peter Friedrich	Cürie, Peter Friedrich
Dachnowski	Dachnowski-Stokes	Dachnowski-Stokes, Alfred Paul	Dachnowski-Stokes, Alfred Paul
Dadre	Dadre	Dadre, Ernesto	Dadre, Ernesto
Daenzer	Daenzer	Daenzer, F.G.	Daenzer, F.G.
Dafert	Dafert	Dafert, Otto	Dafert, Otto
Daffner	Daffner	Daffner, Franz	Daffner, Franz
Daglish	Daglish	Daglish, Eric Fitch	Daglish, Eric Fitch
Daguillon	Daguillon	Daguillon, Auguste Prosper	Daguillon, Auguste Prosper
Dagys	Dagys	Dagys, Jonas	Dagys, Jonas
K.Dahl	Dahl	Dahl, Knut	Dahl, Knut
Dahlberg	Dahlberg	Dahlberg, Carl Gustav	Dahlberg, Carl Gustav
J.A.Dahlgren	Dahlgren	Dahlgren, John Adolph Ebbeson	Dahlgren, John Adolph Ebbeson
K.V.O.Dahlgren	Dahlgren	Dahlgren, [Karl Vilhelm] Ossian	Dahlgren, Ossian
M.Dahmen	Dahmen	Dahmen, M.C.	Dahmen, M.C.
W.Dahms	Dahms	Dahms, W.	Dahms, W.
Dahnke	Dahnke	Dahnke, Walter Wilhelm Ludwig	Dahnke, Walter Wilhelm Ludwig
Daigremont	Daigremont	Daigremont, Mme. J.	Daigremont, Mme. J.
Daines	Daines	Daines, Lyman Luther	Daines, Lyman Luther
Dakkus	Dakkus	Dakkus, Pieter Martinus Wilhelminus	Dakkus, Pieter Martinus Wilhelminus
Dalbis	Dalbis	Dalbis, Louis Janvier	Dalbis, Louis Janvier
Dalgado	Dalgado	Dalgado, Daniel Gelásio	Dalgado, Daniel Gelásio
W.H.Dall	Dall	Dall, William Healey	Dall, William Healey
Dalla Fior	Dalla Fior	Dalla Fior, Giuseppe	Dalla Fior, Giuseppe
Dalla Porta	Dalla Porta	Dalla Porta, Niccolò	Dalla Porta, Niccolò
Dallas	Dallas	Dallas, Ellen Markoe (née Wharton)	Dallas, Ellen Markoe
Dalmer	Dalmer	Dalmer, Moritz	Dalmer, Moritz
Dalmon	Dalmon	Dalmon, Jules	Dalmon, Jules
H.G.Dalton	Dalton	Dalton, Henry G.	Dalton, Henry G.
James Dalton	Dalton	Dalton, James, senior	Dalton, James, senior
John Dalton	Dalton	Dalton, John	Dalton, John
Dame	Dame	Dame, Lorin Low	Dame, Lorin Low
Damseaux	Damseaux	Damseaux, Adolph	Damseaux, Adolph
F.T.Dana	Dana	Dana, Frances Theodora (neé Smith; afterwards Parsons)	Dana, Frances Theodora
Dancer	Dancer	Dancer, Thomas	Dancer, Thomas
Dandois	Dandois	Dandois, Honoré	Dandois, Honoré
Danforth	Danforth	Danforth, Charles Haskell	Danforth, Charles Haskell
J.L.Daniel	Daniel	Daniel, Jean-Lucien	Daniel, Jean-Lucien
Danielli	Danielli [Danieli]	Danielli [Danieli], Jacopo	Danielli, Jacopo
J.F.Dannemann	Dannemann	Dannemann, Johann Friedrich	Dannemann, Johann Friedrich
Danzel	Danzel	Danzel, Johann Friedrich Nikolaus	Danzel, Johann Friedrich Nikolaus
Danèk	Danèk	Danèk, Gustav	Danèk, Gustav
A.D.Darb.	Darbishire	Darbishire, Arthur Dukinfield	Darbishire, Arthur Dukinfield
C.A.Darling	Darling	Darling, Chester Arthur	Darling, Chester Arthur
H.R.Darl.	Darlington	Darlington, Hayward Radcliffe	Darlington, Hayward Radcliffe
F.Darwin	Darwin	Darwin, Francis	Darwin, Francis
R.Darwin	Darwin	Darwin, Robert Waring	Darwin, Robert Waring
S.N.Das Gupta	Das Gupta	Das Gupta, Sanchindra Nath	Das Gupta, Sanchindra Nath
Dassen	Dassen	Dassen, Michiel [Michael]	Dassen, Michiel
Daubenmire	Daubenmire	Daubenmire, Rexford F.	Daubenmire, Rexford F.
A.Dauber	Dauber	Dauber, Adolf	Dauber, Adolf
L.Dauber	Dauber	Dauber, Ludwig	Dauber, Ludwig
Daumann	Daumann	Daumann, Erich	Daumann, Erich
Dauphiné	Dauphiné	Dauphiné, André	Dauphiné, André
Davel	Davel	Davel, Ricordo J.	Davel, Ricordo J.
C.B.Davenp.	Davenport	Davenport, Charles Benedict	Davenport, Charles Benedict
E.David	David	David, Elisabeth	David, Elisabeth
P.A.David	David	David, Philippe Aimée	David, Philippe Aimée
Eu.Davids	Davids	Davids, Eugen	Davids, Eugen
A.J.Davidson	Davidson	Davidson, Alice Jane (née Merritt)	Davidson, Alice Jane
J.Davidson	Davidson	Davidson, John	Davidson, John
Davie	Davie	Davie, Robert Chapman	Davie, Robert Chapman
W.Davies	Davies	Davies, William	Davies, William
Davin	Davin	Davin, Vincent	Davin, Vincent
C.A.Davis	Davis	Davis, Charles Albert	Davis, Charles Albert
Cons.Davis	Davis	Davis, Consett	Davis, Consett
Davy de Virville	Davy de Virville	Davy de Virville, Adrien	Davy de Virville, Adrien
Dawodu	Dawodu	Dawodu, Thomas B.	Dawodu, Thomas B.
G.M.Dawson	Dawson	Dawson, George Mercer	Dawson, George Mercer
M.Dawson	Dawson	Dawson, Maria	Dawson, Maria
D.F.Day	Day	Day, David Fisher	Day, David Fisher
R.N.Day	Day	Day, Reuben Noble	Day, Reuben Noble
De Bonis	De Bonis	De Bonis, Antonio	De Bonis, Antonio
De Crespigny	De Crespigny	De Crespigny, Eyre Champion	De Crespigny, Eyre Champion
De Friese	De Friese	De Friese, Lafayette Hoyt	De Friese, Lafayette Hoyt
De Loach	De Loach	De Loach, Robert John Henderson	De Loach, Robert John Henderson
De Vos	De Vos	De Vos, Cornelis	De Vos, Cornelis
A.De Vos	De Vos [Devos]	De Vos [Devos], André Pascal Alexander	De Vos, André Pascal Alexander
Pylaie	De la Pylaie	De la Pylaie, Auguste Jean Marie Bachelot	De la Pylaie, Auguste Jean Marie Bachelot
A.F.Dean	Dean	Dean, Aletta Friscone	Dean, Aletta Friscone
B.Dean	Dean	Dean, Bashford	Dean, Bashford
F.W.Dean	Dean	Dean, F.W.	Dean, F.W.
E.Debes	Debes	Debes, E.	Debes, E.
Debold	Debold	Debold, Rudolf	Debold, Rudolf
F.G.Debray	Debray	Debray, Ferdinand Gustave	Debray, Ferdinand Gustave
S.Decker	Decker	Decker, [João] Siegfried	Decker, Siegfried
Decrock	Decrock	Decrock, Éllie	Decrock, Éllie
Decuillé	Decuillé	Decuillé, Charles	Decuillé, Charles
Dědeček	Dedecek	Dědeček, Josef	Dědeček, Josef
Degenkolbe	Degenkolbe	Degenkolbe, Walther	Degenkolbe, Walther
Degrully	Degrully	Degrully, Leon	Degrully, Leon
C.L.F.Dehay	Dehay	Dehay, Charles-Louis-Ferdinand	Dehay, Charles-Louis-Ferdinand
M.Dehmel	Dehmel	Dehmel, Max	Dehmel, Max
Dehnecke	Dehnecke	Dehnecke, Heinrich Martin Carl	Dehnecke, Heinrich Martin Carl
Deigthon	Deigthon	Deigthon, Frederick Claude	Deigthon, Frederick Claude
Deinega	Deinega	Deinega, V.	Deinega, V.
Deiniger	Deiniger	Deiniger, August	Deiniger, August
Dekhuyzen	Dekhuyzen	Dekhuyzen, Marinus Cornelis	Dekhuyzen, Marinus Cornelis
Delabarre	Delabarre	Delabarre, Edmund Burke	Delabarre, Edmund Burke
Delachapelle	Delachapelle	Delachapelle, Pierre-Adrien	Delachapelle, Pierre-Adrien
J.Delacr.	Delacroix	Delacroix, Jean	Delacroix, Jean
Delalande	Delalande	Delalande, Pierre Antoine	Delalande, Pierre Antoine
J.M.Delalande	Delalande	Delalande, Jean Marie	Delalande, Jean Marie
E.-A.Delamare	Delamare	Delamare, Ernest-Amédée	Delamare, Ernest-Amédée
Delarge	Delarge	Delarge, Léon Charles Albert	Delarge, Léon Charles Albert
J.Delaunay	Delaunay	Delaunay, (Parfait-Gervais) dit Jules	Delaunay, dit Jules
P.Delaunay	Delaunay	Delaunay, Paul	Delaunay, Paul
Delbos	Delbos	Delbos, Joseph	Delbos, Joseph
Delbrouck	Delbrouck	Delbrouck, Conrad	Delbrouck, Conrad
Delchevalerie	Delchevalerie	Delchevalerie, Gustav	Delchevalerie, Gustav
Delevoy	Delevoy	Delevoy, Gaston C.A.	Delevoy, Gaston C.A.
Delille, Abbé	Delille	Delille, [Jacques Monanier, called] Abbé	Delille, Abbé
Dellert	Dellert	Dellert, Rosa	Dellert, Rosa
Dellien	Dellien	Dellien, Friedrich	Dellien, Friedrich
Delmas	Delmas	Delmas, Hugues	Delmas, Hugues
Delondre	Delondre	Delondre, Auguste	Delondre, Auguste
H.Delpy	Delpy	Delpy, Hedwig	Delpy, Hedwig
D.Demaree	Demaree	Demaree, Delzie	Demaree, Delzie
Dembosz	Dembosz	Dembosz, Stanislaw	Dembosz, Stanislaw
Dembowski	Dembowski	Dembowski, Johann	Dembowski, Johann
Demerec	Demerec	Demerec, Milislav	Demerec, Milislav
Demerson	Demerson	Demerson, L.	Demerson, L.
A.N.Demidow	Demidow	Demidow, Anatoli Nikolajewitsch	Demidow, Anatoli Nikolajewitsch
Denaiffe	Denaiffe	Denaiffe, Clément	Denaiffe, Clément
Dendy	Dendy	Dendy, Arthur	Dendy, Arthur
Denesle	Denesle	Denesle, J.A.N.	Denesle, J.A.N.
H.J.Denham	Denham	Denham, Humphrey John	Denham, Humphrey John
Deniker	Deniker	Deniker, Joseph	Deniker, Joseph
Dening	Dening	Dening, Karl Heinrich August	Dening, Karl Heinrich August
L.Denise	Denise	Denise, Louis	Denise, Louis
Dennert	Dennert	Dennert, Eberhard	Dennert, Eberhard
Denniston	Denniston	Denniston, Rollin Henry	Denniston, Rollin Henry
Dens	Dens	Dens, Georges	Dens, Georges
Densmore	Densmore	Densmore, Hiram Delos	Densmore, Hiram Delos
F.T.Densmore	Densmore	Densmore, Frances Theresa	Densmore, Frances Theresa
Dent	Dent	Dent, Hastings Charles	Dent, Hastings Charles
G.Denys	Denys	Denys, Gerhard	Denys, Gerhard
Depape	Depape	Depape, Georges-Albert-Joseph	Depape, Georges-Albert-Joseph
Derby	Derby	Derby, Orville [Adalberto]	Derby, Orville
Derbés	Derbès	Derbès, Auguste Alphonse	Derbès, Auguste Alphonse
C.M.Derick	Derick	Derick, (Miss) Carrie Matilda	Derick, Carrie Matilda
Derks	Derks	Derks, Karsje	Derks, Karsje
Desnoix	Desnoix	Desnoix, Charles Julien	Desnoix, Charles Julien
Desplats	Desplats	Desplats, V.	Desplats, V.
Desruisseaux	Desruisseaux	Desruisseaux, P. Advisse	Desruisseaux, P. Advisse
Dessalle	Dessalle	Dessalle, Louis-Auguste	Dessalle, Louis-Auguste
Destremx	Destremx	Destremx, Jean Jacques	Destremx, Jean Jacques
Destruge	Destruge	Destruge, Alcides	Destruge, Alcides
Determe	Determe	Determe, Clément Julien Théophile	Determe, Clément Julien Théophile
Dethan	Dethan	Dethan, Georges	Dethan, Georges
Detmer	Detmer	Detmer, Wilhelm [Alexander]	Detmer, Wilhelm
Detto	Detto	Detto, Carl Albert Eduard	Detto, Carl Albert Eduard
Deuerling	Deuerling	Deuerling, Oswald	Deuerling, Oswald
Devauv.	Devauversin	Devauversin, A.	Devauversin, A.
Devaux	Devaux	Devaux, Henri Edgar	Devaux, Henri Edgar
Devez	Devez	Devez, G.	Devez, G.
Devold	Devold	Devold, Joakim	Devold, Joakim
Dewalque	Dewalque	Dewalque, Gilles Joseph Gustave	Dewalque, Gilles Joseph Gustave
Diapoulis	Diapoulis [Diapulis]	Diapoulis [Diapulis], Charalambos A. [K.A.]	Diapoulis, Charalambos A.
Dibbern	Dibbern	Dibbern, Hermann [Friedrich Wilhelm]	Dibbern, Hermann
J.Dick	Dick	Dick, Julius	Dick, Julius
R.Dick	Dick	Dick, Robert	Dick, Robert
Sydn.Dickinson	Dickinson	Dickinson, Sydney	Dickinson, Sydney
A.Dicks.	Dickson	Dickson, Alexander	Dickson, Alexander
A.Didr.	Didrichsen	Didrichsen, Axel	Didrichsen, Axel
R.Dieder.	Diederichs	Diederichs, Rudolf	Diederichs, Rudolf
Diemont	Diemont	Diemont, Willem Herbert	Diemont, Willem Herbert
Diercke	Diercke	Diercke, Carl	Diercke, Carl
Dieren	Dieren	Dieren, Jacobus Wonterus van	Dieren, Jacobus Wonterus van
Amalie Dietr.	Dietrich	Dietrich, Amalie [née Nellen]	Dietrich, Amalie
F.C.Dietr.	Dietrich	Dietrich, Friedrich Carl	Dietrich, Friedrich Carl
Diettrich-Kalkh.	Diettrich-Kalkhoff	Diettrich-Kalkhoff, Emil Georg Friedrich	Diettrich-Kalkhoff, Emil Georg Friedrich
R.Diez	Diez	Diez, Rudolf	Diez, Rudolf
L.Digby	Digby	Digby, Lettice	Digby, Lettice
Dihm	Dihm	Dihm, Hugo (born as Hugo Jerschke)	Dihm, Hugo
E.O.Dill	Dill	Dill, Ernst Oscar	Dill, Ernst Oscar
Dillenius	Dillenius	Dillenius, Johann Baptist(a) Joseph	Dillenius, Johann Baptist Joseph
Dillon-Weston	Dillon-Weston	Dillon-Weston, William Alastair Royal	Dillon-Weston, William Alastair Royal
Dinand	Dinand	Dinand, August Paul	Dinand, August Paul
A.Dinter	Dinter	Dinter, Arthur	Dinter, Arthur
G.G.Dittrich	Dittrich	Dittrich, Georg Gustav	Dittrich, Georg Gustav
Dittw.	Dittweiler	Dittweiler, Wilhelm	Dittweiler, Wilhelm
P.Dive	Dive	Dive, Paul	Dive, Paul
Divers	Divers	Divers, W.H.	Divers, W.H.
E.Dix	Dix	Dix, Emily	Dix, Emily
J.Dix.	Dix	Dix, Johan [John] Frederik Christiaan	Dix, Johan Frederik Christiaan
P.D.Dixit	Dixit	Dixit, P.D.	Dixit, P.D.
H.H.Dixon	Dixon	Dixon, Henry Horatio	Dixon, Henry Horatio
W.A.Dixon	Dixon	Dixon, Will A.	Dixon, Will A.
Doak	Doak	Doak, Clifton Childress	Doak, Clifton Childress
Dobe	Dobe	Dobe, Paul	Dobe, Paul
Dobronz	Dobronz	Dobronz, Klaus	Dobronz, Klaus
Dobrowolski	Dobrowolski	Dobrowolski, Jan Marjan	Dobrowolski, Jan Marjan
Dobzhansky	Dobzhansky	Dobzhansky, Theodosius	Dobzhansky, Theodosius
Doct.v.Leeuwen	Docters van Leeuwen	Docters van Leeuwen, Willem Marius	Docters van Leeuwen, Willem Marius
Dodel	Dodel[-Port]	Dodel[-Port], Arnold	Dodel, Arnold
C.K.Dodge	Dodge	Dodge, Charles Keene	Dodge, Charles Keene
C.R.Dodge	Dodge	Dodge, Charles Richard	Dodge, Charles Richard
Doebner	Doebner	Doebner, Eduard Philipp	Doebner, Eduard Philipp
Doisy	Doisy	Doisy, Charles	Doisy, Charles
Dolk	Dolk	Dolk, Herman Elisa	Dolk, Herman Elisa
Dolley	Dolley	Dolley, Charles Sumner	Dolley, Charles Sumner
Adr.Dollfus	Dollfus	Dollfus, Adrien	Dollfus, Adrien
R.Dollfus	Dollfus	Dollfus, Robert	Dollfus, Robert
Domaradsky	Domaradsky	Domaradsky, M.	Domaradsky, M.
Dominique	Dominique	Dominique, [Abbé] Jules	Dominique, Jules
Dompierre	Dompierre	Dompierre, Joseph Theodor	Dompierre, Joseph Theodor
G.Don sr.	Don	Don, George (1764-1814)	Don, George
N.C.Donaldson	Donaldson	Donaldson, Noble Clark	Donaldson, Noble Clark
Doncaster	Doncaster	Doncaster, Leonard	Doncaster, Leonard
Donckier	Donckier de Donceel	Donckier de Donceel, Henri	Donckier de Donceel, Henri
Dondé	Dondé Ibarra	Dondé Ibarra, Joaquim	Dondé Ibarra, Joaquim
Doposcheg	Doposcheg-Uhlár	Doposcheg-Uhlár, Joseph	Doposcheg-Uhlár, Joseph
Dorety	Dorety	Dorety, Helen Angela	Dorety, Helen Angela
Dormon	Dormon	Dormon, [Miss] Carolyn Coroneos	Dormon, Carolyn Coroneos
F.O.Dorn	Dorn	Dorn, Friedrich Otto	Dorn, Friedrich Otto
H.B.Dorner	Dorner	Dorner, Herman Bernard	Dorner, Herman Bernard
N.J.Dorof.	Dorofejew	Dorofejew, Nikolai Jewdokim	Dorofejew, Nikolai Jewdokim
Dorph-Petersen	Dorph-Petersen	Dorph-Petersen, Knud	Dorph-Petersen, Knud
R.Dostál	Dostál	Dostál, Rudolf	Dostál, Rudolf
N.Doubleday	Doubleday	Doubleday, Neltje (De Graff) (Neltje Blanchan)	Doubleday, Neltje
G.E.Douglas	Douglas	Douglas, Gertrude Elizabeth	Douglas, Gertrude Elizabeth
A.E.Douglass	Douglass	Douglass, Andrew Ellicott	Douglass, Andrew Ellicott
Douliot	Douliot	Douliot, Henri Louis	Douliot, Henri Louis
Doumenjou	Doumenjou	Doumenjou, Jean-Bazile	Doumenjou, Jean-Bazile
Douteau	Douteau	Douteau, Jules J.	Douteau, Jules J.
Dowd	Dowd	Dowd, Alice M.	Dowd, Alice M.
Dowden	Dowden	Dowden, Richard	Dowden, Richard
Dowling	Dowling	Dowling, Alfred E.P. Raymund	Dowling, Alfred E.P. Raymund
A.J.Downing	Downing	Downing, Andrew Jackson	Downing, Andrew Jackson
J.Doyle	Doyle	Doyle, Joseph	Doyle, Joseph
Doûmet-Adanson	Doûmet-Adanson	Doûmet-Adanson, Paul-Napoléon	Doûmet-Adanson, Paul-Napoléon
Dracinschi	Dracinschi	Dracinschi, Margit	Dracinschi, Margit
J.G.N.Dragend.	Dragendorff	Dragendorff, Johann Georg Noël	Dragendorff, Johann Georg Noël
Draghetti	Draghetti	Draghetti, A.	Draghetti, A.
Draheim	Draheim	Draheim, Walter	Draheim, Walter
Drahowzal	Drahowzal	Drahowzal, Grete	Drahowzal, Grete
Drake-Brockman	Drake-Brockman	Drake-Brockman, Ralph Evelyn	Drake-Brockman, Ralph Evelyn
J.Drayton	Drayton	Drayton, John	Drayton, John
Dreier	Dreier	Dreier, Johannes Caspar Heinrich	Dreier, Johannes Caspar Heinrich
Dresler	Dresler	Dresler, Ernst Friedrich	Dresler, Ernst Friedrich
Drewitt	Drewitt	Drewitt, Frederic George Dawtrey	Drewitt, Frederic George Dawtrey
H.Driesch	Driesch	Driesch, Hans Adolf Eduard	Driesch, Hans Adolf Eduard
Driggs	Driggs	Driggs, Alfred Waldo	Driggs, Alfred Waldo
H.Driver	Driver	Driver, Heinrich Friedrich Theodor Martin	Driver, Heinrich Friedrich Theodor Martin
Dronke	Dronke	Dronke, Julius Heinrich Albert	Dronke, Julius Heinrich Albert
Droysen	Droysen	Droysen, Karl Johann	Droysen, Karl Johann
A.T.Drumm.	Drummond	Drummond, Andrew Thomas	Drummond, Andrew Thomas
Dryander	Dryander	Dryander, Jonas Carlsson	Dryander, Jonas Carlsson
Drümpelmann	Drümpelmann [Drimpelman]	Drümpelmann [Drimpelman], Ernst Wilhelm	Drümpelmann, Ernst Wilhelm
F.G.L.Du Cane	Du Cane	Du Cane, Florence Gertrude Louisa	Du Cane, Florence Gertrude Louisa
Du Chastel	Du Chastel	Du Chastel, Ferdinand [Comte]	Du Chastel, Ferdinand
Du Molin	Du Molin	Du Molin, Jean Baptiste	Du Molin, Jean Baptiste
Dubian	Dubian	Dubian, Robert	Dubian, Robert
A.Dubois	Dubois	Dubois, A.	Dubois, A.
F.Dubois	Dubois	Dubois, François	Dubois, François
Duboul	Duboul	Duboul, A.	Duboul, A.
L.Ducamp	Ducamp	Ducamp, Louis	Ducamp, Louis
Duchaussoy	Duchaussoy	Duchaussoy, H.	Duchaussoy, H.
E.A.Duchesne	Duchesne	Duchesne, Edouard Adolphe	Duchesne, Edouard Adolphe
Fl.Duchesne	Duchesne	Duchesne, Fl.	Duchesne, Fl.
J.N.Duck	Duck	Duck, John Nehemiah	Duck, John Nehemiah
Duclerget	Duclerget	Duclerget, Jean	Duclerget, Jean
Ducom	Ducom	Ducom, L.	Ducom, L.
F.Ducos	Ducos	Ducos, F.	Ducos, F.
G.C.Dudgeon	Dudgeon	Dudgeon, Gerald Cecil	Dudgeon, Gerald Cecil
W.S.Dudgeon	Dudgeon	Dudgeon, Winfield Scott	Dudgeon, Winfield Scott
J.Dufour	Dufour	Dufour, Jean	Dufour, Jean
É.Dufour	Dufour	Dufour, Édouard	Dufour, Édouard
Dufrené	Dufrené	Dufrené, Hector	Dufrené, Hector
Dufrénoy	Dufrénoy	Dufrénoy, Jean	Dufrénoy, Jean
Dujard.-Beaum.	Dujardin-Beaumetz	Dujardin-Beaumetz, Georges Octave	Dujardin-Beaumetz, Georges Octave
Dujarric	Dujarric de la Rivière	Dujarric de la Rivière, René	Dujarric de la Rivière, René
A.Dumont	Dumont	Dumont, Arthur	Dumont, Arthur
Dumont-Carment	Dumont-Carment	Dumont-Carment	Dumont-Carment
L.J.G.Dumoulin	Dumoulin	Dumoulin, L.J.G.	Dumoulin, L.J.G.
J.B.Duncan	Duncan	Duncan, John Bishop	Duncan, John Bishop
B.J.J.Duncker	Duncker	Duncker, Bernardus Johannes Josephus	Duncker, Bernardus Johannes Josephus
E.M.Dunham	Dunham	Dunham, Elizabeth Marie [née Pennell]	Dunham, Elizabeth Marie
F.Dunlap	Dunlap	Dunlap, Frederick	Dunlap, Frederick
G.A.Dunlop	Dunlop	Dunlop, Gavin Alfred	Dunlop, Gavin Alfred
Dunselman	Dunselman	Dunselman, J.	Dunselman, J.
Dupler	Dupler	Dupler, Alphaeus William	Dupler, Alphaeus William
S.J.Duplessis	Duplessis	Duplessis, Stefanus Johannes	Duplessis, Stefanus Johannes
Duplessy	Duplessy	Duplessy, F. S.	Duplessy, F. S.
J.D.Dupont	Dupont	Dupont, J.D.C.	Dupont, J.D.C.
Duppa	Duppa	Duppa, Richard	Duppa, Richard
D.Dupuy	Dupuy	Dupuy, Dominique	Dupuy, Dominique
Duque Jaramillo	Duque Jaramillo	Duque Jaramillo, José [Jesus] Maria	Duque Jaramillo, José Maria
Duquesne	Duquesne	Duquesne, A.	Duquesne, A.
Eug.Durand	Durand	Durand, Eugène	Durand, Eugène
Herb.Durand	Durand	Durand, Herbert	Durand, Herbert
Dureau	Dureau de la Malle [Lamalle]	Dureau de la Malle [Lamalle], Adolphe Auguste Jules César	Dureau de la Malle, Adolphe Auguste Jules César
C.J.Durheim	Durheim	Durheim, Carl (Karl) Jakob	Durheim, Carl Jakob
Durin	Durin	Durin, E.	Durin, E.
K.F.Dusén	Dusén	Dusén, Karl Fredrik	Dusén, Karl Fredrik
Dutailly	Dutailly	Dutailly, Gustave [Didier Edmé Rodolphe]	Dutailly, Gustave
Dutcher	Dutcher	Dutcher, Basil Hicks	Dutcher, Basil Hicks
D.Dutoit	Dutoit	Dutoit, Daniel	Dutoit, Daniel
E.Dutoit	Dutoit[-Haller]	Dutoit[-Haller], Eugen	Dutoit, Eugen
Cl.Duval	Duval	Duval, Clotaire	Duval, Clotaire
Duvau	Duvau	Duvau, Auguste	Duvau, Auguste
G.Duvernoy	Duvernoy	Duvernoy, Georg Ludwig	Duvernoy, Georg Ludwig
Duysen	Duysen	Duysen, Franz	Duysen, Franz
Duyster	Duyster	Duyster, Marinus	Duyster, Marinus
Dye	Dye	Dye, Clair Albert	Dye, Clair Albert
Dymock	Dymock	Dymock, William	Dymock, William
Déhérain	Déhérain	Déhérain, Pierre Paul	Déhérain, Pierre Paul
Déniau	Déniau	Déniau, P.C. Félix	Déniau, P.C. Félix
Déterville	Déterville	Déterville	Déterville
A.Déy	Déy	Déy, Aristide	Déy, Aristide
Döderlein	Döderlein	Döderlein, Ludwig Heinrich Philipp	Döderlein, Ludwig Heinrich Philipp
Dönhoff	Dönhoff	Dönhoff, Paul	Dönhoff, Paul
Dörries	Dörries	Dörries, Wilhelm	Dörries, Wilhelm
Düggeli	Düggeli	Düggeli, Max	Düggeli, Max
Dummer	Dümmer	Dümmer, Richard Arnold	Dümmer, Richard Arnold
Dürken	Dürken	Dürken, Bernhard Heinrich	Dürken, Bernhard Heinrich
J.Earle	Earle	Earle, [Rev.] John	Earle, John
East	East	East, Edward Murray	East, Edward Murray
Ebbinghaus	Ebbinghaus	Ebbinghaus, Julius	Ebbinghaus, Julius
S.T.Ebel	Ebel	Ebel, Samuel Theodor	Ebel, Samuel Theodor
Ebeling	Ebeling	Ebeling, [Rudolf] Max	Ebeling, Max
E.Eber	Eber	Eber, Erna	Eber, Erna
Eberdt	Eberdt	Eberdt, Oscar	Eberdt, Oscar
Eberhard	Eberhard	Eberhard, Carl	Eberhard, Carl
A.Eberh.	Eberhardt	Eberhardt, Albert	Eberhardt, Albert
G.Eberle	Eberle	Eberle, Georg J.	Eberle, Georg J.
Eberlein	Eberlein	Eberlein, Ludwig	Eberlein, Ludwig
F.Ebert	Ebert	Ebert, Felix	Ebert, Felix
W.Ebert	Ebert	Ebert, Wilhelm	Ebert, Wilhelm
Ebray	Ebray	Ebray, Charles-Henri-Théophile	Ebray, Charles-Henri-Théophile
Echegaray	Echegaray	Echegaray, Saile	Echegaray, Saile
Eckardt	Eckardt	Eckardt, [Gustav] Theo [Peter Hans]	Eckardt, Theo
W.R.E.Eckardt	Eckardt	Eckardt, Wilhelm Richard Ernst	Eckardt, Wilhelm Richard Ernst
Eckerberg	Eckerberg	Eckerberg, Johann Gustaf	Eckerberg, Johann Gustaf
Eckman	Eckman	Eckman, Pehr Immanuel	Eckman, Pehr Immanuel
Edelhoff	Edelhoff	Edelhoff, Edwin	Edelhoff, Edwin
Edeling	Edeling	Edeling, A.C.J.	Edeling, A.C.J.
Edgren	Edgren	Edgren, Peter Adolph	Edgren, Peter Adolph
F.L.G.Edlich	Edlich	Edlich, Freimut Leberecht Gottwald	Edlich, Freimut Leberecht Gottwald
G.Edman	Edman	Edman, Gösta	Edman, Gösta
H.T.Edwards	Edwards	Edwards, Harry Taylor	Edwards, Harry Taylor
J.K.Edwards	Edwards	Edwards, John Keith	Edwards, John Keith
A.C.Eeden	Eeden	Eeden, A.C. van	Eeden, A.C. van
Egenter	Egenter	Egenter, Joseph	Egenter, Joseph
Egert.-Warb.	Egerton-Warburton	Egerton-Warburton, Geoffrey	Egerton-Warburton, Geoffrey
Eggemann	Eggemann	Eggemann, H.	Eggemann, H.
H.Eggers	Eggers	Eggers, Heinrich	Eggers, Heinrich
J.Eggert	Eggert	Eggert, Johann	Eggert, Johann
Ehrmann	Ehrmann	Ehrmann, P.	Ehrmann, P.
Eichenfeld	Eichenfeld	Eichenfeld, Michael Ritter von	Eichenfeld, Michael Ritter von
Eichholz	Eichholz	Eichholz, Georg	Eichholz, Georg
A.Eichhorn	Eichhorn	Eichhorn, André	Eichhorn, André
Eichinger	Eichinger	Eichinger, Alfons	Eichinger, Alfons
J.A.Eichler	Eichler	Eichler, Johann Adam	Eichler, Johann Adam
K.Eichler	Eichler	Eichler, Karl	Eichler, Karl
Eigsti	Eigsti	Eigsti, Orie Jacob	Eigsti, Orie Jacob
Eilker	Eilker	Eilker, Georg	Eilker, Georg
Eimbcke	Eimbcke	Eimbcke, Georg	Eimbcke, Georg
Einbeck	Einbeck	Einbeck, Otto Ernst Karl	Einbeck, Otto Ernst Karl
Eiselen	Eiselen	Eiselen, Johannes	Eiselen, Johannes
Eisen	Eisen	Eisen, August Gustaf (Gustavus Augustus)	Eisen, August Gustaf
Eisengrein	Eisengrein	Eisengrein, Georg Adolf	Eisengrein, Georg Adolf
Eisentr.	Eisentraeger	Eisentraeger, Otto Karl Louis Emil	Eisentraeger, Otto Karl Louis Emil
Ekeberg	Ekeberg	Ekeberg, Carl Gustaf	Ekeberg, Carl Gustaf
Ekegreen	Ekegreen	Ekegreen, Carolus Petrus	Ekegreen, Carolus Petrus
Ekkert	Ekkert	Ekkert, Josef	Ekkert, Josef
G.M.Eklund	Eklund	Eklund, G.M.	Eklund, G.M.
F.L.Ekman	Ekman	Ekman, Frederik Laurentz	Ekman, Frederik Laurentz
El-Nayal	El-Nayal	El-Nayal, A.A.	El-Nayal, A.A.
Elbert	Elbert	Elbert, Johannes [Eugen Wilhelm]	Elbert, Johannes
K.O.Elfving	Elfving	Elfving, Karl Oskar	Elfving, Karl Oskar
W.A.Eliot	Eliot	Eliot, Willard Ayres	Eliot, Willard Ayres
W.G.Eliot	Eliot	Eliot, W.G.	Eliot, W.G.
Elkins	Elkins	Elkins, Marion Graham	Elkins, Marion Graham
Ellacombe	Ellacombe	Ellacombe, [Rev.] Henry Nicholson	Ellacombe, Henry Nicholson
W.Elliot	Elliot	Elliot, Sir Walter	Elliot, Sir Walter
G.Elliott	Elliott	Elliott, George Francis Scott	Elliott, George Francis Scott
W.T.Elliott	Elliott	Elliott, William Thomas	Elliott, William Thomas
Elminger	Elminger	Elminger, Joseph	Elminger, Joseph
Elo	Elo	Elo, Juho Erkki	Elo, Juho Erkki
Eloffe	Eloffe	Eloffe, Arthur	Eloffe, Arthur
R.P.Elrod	Elrod	Elrod, Ralph Perry	Elrod, Ralph Perry
Elsler	Elsler	Elsler, Ernst	Elsler, Ernst
Elst	Elst	Elst, Paulus von der	Elst, Paulus von der
Eltinge	Eltinge	Eltinge, Ethel Taber	Eltinge, Ethel Taber
Elvers	Elvers	Elvers, Ivar	Elvers, Ivar
Embden	Embden	Embden, Arthur	Embden, Arthur
Embury	Embury	Embury, Emma Catherine [née Manley]	Embury, Emma Catherine
G.B.Emers.	Emerson	Emerson, George Barrell	Emerson, George Barrell
R.A.Emers.	Emerson	Emerson, Rollins Adams	Emerson, Rollins Adams
Empeyta	Empeyta	Empeyta, Eugène	Empeyta, Eugène
Emrich	Emrich	Emrich, Karl	Emrich, Karl
Endriss	Endriss	Endriss, W.	Endriss, W.
Endter	Endter	Endter, Heinrich Christian Gottlieb	Endter, Heinrich Christian Gottlieb
Heinr.Engel	Engel	Engel, Heinrich	Engel, Heinrich
C.W.Engelm.	Engelmann	Engelmann, Christoph Wilhelm	Engelmann, Christoph Wilhelm
Arn.Engl.	Engler	Engler, Arnold	Engler, Arnold
Engstf.	Engstfeld	Engstfeld, E.	Engstfeld, E.
Ennis	Ennis	Ennis, Beulah Pearl	Ennis, Beulah Pearl
Entleutner	Entleutner	Entleutner, Anton F.	Entleutner, Anton F.
O.Ernst	Ernst	Ernst, Otto	Ernst, Otto
Ervideira	Ervideira	Ervideira, Artur	Ervideira, Artur
Eschenbach	Eschenbach	Eschenbach, Johann Friedrich	Eschenbach, Johann Friedrich
Esenbeck	Esenbeck	Esenbeck, Ernst	Esenbeck, Ernst
Espenscheid	Espenscheid	Espenscheid, Eduard jr.	Espenscheid, Eduard jr.
F.M.Essig	Essig	Essig, Frederick Monroe	Essig, Frederick Monroe
Etheridge	Etheridge	Etheridge, Robert Jr.	Etheridge, Robert Jr.
Eudenstein	Eulenstein	Eulenstein, Theodor	Eulenstein, Theodor
Ewer	Ewer	Ewer, Samuel	Ewer, Samuel
Ewing	Ewing	Ewing, Peter	Ewing, Peter
Exo	Exo	Exo, Arthur	Exo, Arthur
Eykman	Eykman	Eykman, Johan Frederik	Eykman, Johan Frederik
Eyrich	Eyrich	Eyrich, Ludwig	Eyrich, Ludwig
Eys	Eys	Eys, Jan Nicolaas van	Eys, Jan Nicolaas van
Eysel	Eysel	Eysel, Georg	Eysel, Georg
A.Faber	Faber	Faber, Albrecht	Faber, Albrecht
Facch.	Facchini	Facchini, Francesco	Facchini, Francesco
Fahl	Fahl	Fahl, Robert	Fahl, Robert
Fahrendorff	Fahrendorff	Fahrendorff, Ernst	Fahrendorff, Ernst
Faideau	Faideau	Faideau, Ferdinand	Faideau, Ferdinand
D.G.Fairchild	Fairchild	Fairchild, David Grandison	Fairchild, David Grandison
H.L.Fairchild	Fairchild	Fairchild, Herman Le Roy	Fairchild, Herman Le Roy
T.Fairchild	Fairchild	Fairchild, Thomas	Fairchild, Thomas
A.Falck	Falck	Falck, [Carl Martin] Alfred [Immanuel]	Falck, Alfred
K.R.Falck	Falck	Falck, Kurt Richard	Falck, Kurt Richard
O.M.Falk	Falk	Falk, Otto Martin	Falk, Otto Martin
Famintsyn	Famintsyn [Famincyn	Famintsyn [Famincyn, Famintzin], Andrei Sergeevich	Famintsyn, Andrei Sergeevich
Fankh.	Fankhauser	Fankhauser, Johannes	Fankhauser, Johannes
Farquet	Farquet	Farquet, Philippe (a.k.a. Alpinus)	Farquet, Philippe
C.H.Farr	Farr	Farr, Clifford Harrison	Farr, Clifford Harrison
W.Farr	Farr	Farr, Wanda (née Kirkbride)	Farr, Wanda
Fassbind	Fassbind	Fassbind, Paula	Fassbind, Paula
Faucheron	Faucheron	Faucheron, Louis Marie	Faucheron, Louis Marie
Faupin	Faupin	Faupin, [Philippe Jules] Ernest	Faupin, Ernest
Fauq.	Fauqueux	Fauqueux, Charles [Armand Léandre]	Fauqueux, Charles
Fauth	Fauth	Fauth, Adolf Heinrich	Fauth, Adolf Heinrich
Ern.Favre	Favre	Favre, Ernest	Favre, Ernest
Ém.Favre	Favre	Favre, Émile-Florentin	Favre, Émile-Florentin
A.Fedch.	Fedchenko	Fedchenko, Aleksei Pavlovich	Fedchenko, Aleksei Pavlovich
Fedchenko ambiguous	Fedchenko [Fedtschenko]	Fedchenko see Fedtschenko	Fedchenko see Fedtschenko
Federley	Federley	Federley, Harry	Federley, Harry
Fehlner	Fehlner	Fehlner, Carl [Karl]	Fehlner, Carl
C.Feistm.	Feistmantel	Feistmantel, Carl [Karl, Karel]	Feistmantel, Carl
Fellerer	Fellerer	Fellerer, Carl	Fellerer, Carl
D.W.Fellows	Fellows	Fellows, Dana Willis	Fellows, Dana Willis
E.Feltgen	Feltgen	Feltgen, Ernst [Ernst]	Feltgen, Ernst
Ferchl	Ferchl	Ferchl, Johann	Ferchl, Johann
W.C.Ferguson	Ferguson	Ferguson, William Cashman	Ferguson, William Cashman
Fermond	Fermond	Fermond, Charles	Fermond, Charles
C.H.Fernald	Fernald	Fernald, Charles Henry	Fernald, Charles Henry
Fernow	Fernow	Fernow, Bernhard Eduard	Fernow, Bernhard Eduard
Ferr.	Ferrari [Ferrarius]	Ferrari [Ferrarius], Giovanni Battista (S.J.)	Ferrari, Giovanni Battista
Ferri	Ferri	Ferri, Giovanni	Ferri, Giovanni
Ferrière	Ferrière	Ferrière, Émile	Ferrière, Émile
Ferry de la Bellone	Ferry de la Bellone	Ferry de la Bellone, Félix Marie Camille de	Ferry de la Bellone, Félix Marie Camille de
Feucht	Feucht	Feucht, Otto	Feucht, Otto
Feuilloux	Feuilloux	Feuilloux, Charles-Jules	Feuilloux, Charles-Jules
Fichera	Fichera	Fichera, Alfio	Fichera, Alfio
Fickel	Fickel	Fickel, Johannes Friedrich	Fickel, Johannes Friedrich
Fiet	Fiet	Fiet, Albert J.J.	Fiet, Albert J.J.
Figdor	Figdor	Figdor, Wilhelm	Figdor, Wilhelm
Figuier	Figuier	Figuier, [Guillaume] Louis	Figuier, Louis
E.Filhol	Filhol	Filhol, [Jean Pierre] Édouard [Bernard]	Filhol, Édouard
F.Finger	Finger	Finger, Ferdinand	Finger, Ferdinand
Firbas	Firbas	Firbas, Franz	Firbas, Franz
E.Fisch	Fisch	Fisch, Ernst	Fisch, Ernst
B.Fischer	Fischer	Fischer, Bernhard	Fischer, Bernhard
C.E.C.Fischer	Fischer	Fischer, Cecil Ernest Claude	Fischer, Cecil Ernest Claude
G.Fisch., Bamb.	Fischer	Fischer, Georg (1844-1941)	Fischer, Georg
G.Fisch., Erl.	Fischer	Fischer, Georg (1876-x)	Fischer, Georg
G.Fisch., Gieboldeh.	Fischer	Fischer, Georg (fl. 1896)	Fischer, Georg
H.W.K.Fisch.	Fischer	Fischer, Hermann [Wilhelm Konrad]	Fischer, Hermann
Th.Fisch.	Fischer	Fischer, Theobald	Fischer, Theobald
G.Fisch.v.Waldh.	Fischer von Waldheim	Fischer von Waldheim, [Johann] Gotthelf [Friedrich]	Fischer von Waldheim, Gotthelf
H.S.Fisher	Fisher	Fisher, Henry Smith	Fisher, Henry Smith
R.Fisher	Fisher	Fisher, Robert (Rev.)	Fisher, Robert
J.G.Fiske	Fiske	Fiske, Jessie Gladys	Fiske, Jessie Gladys
W.Fitch	Fitch	Fitch, Walter Hood	Fitch, Walter Hood
Fitting	Fitting	Fitting, Hans [Johannes] Theodor Gustav Ernst	Fitting, Hans Theodor Gustav Ernst
H.M.Fitzp.	Fitzpatrick	Fitzpatrick, Hugh Maurice	Fitzpatrick, Hugh Maurice
Flacourt	Flacourt	Flacourt, Étienne de (Chevalier)	Flacourt, Étienne de
Flemwell	Flemwell	Flemwell, George Jackson	Flemwell, George Jackson
Flett	Flett	Flett, John Bakkie	Flett, John Bakkie
A.Flod.	Floderus	Floderus, Ali	Floderus, Ali
F.Florsch.	Florschütz	Florschütz, Frans	Florschütz, Frans
Flot	Flot	Flot, Léon Alfred Victor	Flot, Léon Alfred Victor
Flow.	Flowers	Flowers, Seville	Flowers, Seville
H.Flueck	Flueck [Flück]	Flueck [Flück], Hans	Flueck, Hans
Fluggé	Flüggé	Flüggé, Johann(es)	Flüggé, Johann
Fockeu	Fockeu	Fockeu, Henri Louis Jean Baptiste	Fockeu, Henri Louis Jean Baptiste
F.Foerst.	Foerster [Förster]	Foerster [Förster], Friedrich	Foerster, Friedrich
A.Foerster	Foerster [later Förster]	Foerster [later Förster], Arnold	Foerster, Arnold
Fogg	Fogg	Fogg, John Milton, Jr.	Fogg, John Milton, Jr.
Folgner	Folgner	Folgner, Victor [Viktor] Alfred Oswald	Folgner, Victor Alfred Oswald
Folkard	Folkard	Folkard, Richard, Jr.	Folkard, Richard, Jr.
D.Folsom	Folsom	Folsom, Donald	Folsom, Donald
Fonck	Fonck	Fonck, [Johann Christian] Leopold [Leopoldus] [Karl] (S.J.)	Fonck, Leopold
Fonsny	Fonsny	Fonsny, Henri Jacques Philippe	Fonsny, Henri Jacques Philippe
Forchhammer	Forchhammer	Forchhammer, Johan Georg	Forchhammer, Johan Georg
Forenb.	Forenbacher	Forenbacher, Aurel	Forenbacher, Aurel
A.Fors	Fors [y Reyes]	Fors [y Reyes], Alberto J.	Fors, Alberto J.
Forsander	Forsander	Forsander, Johan	Forsander, Johan
Forsberg	Forsberg	Forsberg, Carl Pehr [Peter, Petrus]	Forsberg, Carl Pehr
N.E.Forssell	Forssell	Forssell, Nils Edvard	Forssell, Nils Edvard
Forsström	Forsström	Forsström, Johan Eric	Forsström, Johan Eric
G.Forster	Forster	Forster, Johann Georg [b. George] Adam	Forster, Johann Georg Adam
J.R.Forster	Forster	Forster, Johann Reinhold	Forster, Johann Reinhold
T.F.Forster	Forster	Forster, Thomas Furly	Forster, Thomas Furly
Wm.Forsyth	Forsyth	Forsyth, William	Forsyth, William
H.Fortuné	Fortuné	Fortuné, Henri	Fortuné, Henri
F.Foreau	Foureau	Foureau, Fernand	Foureau, Fernand
J.Fowler	Fowler	Fowler, James (Rev.)	Fowler, James
Fraine	Fraine	Fraine, Ethel Louise de	Fraine, Ethel Louise de
Franc v.Berkhey	Franc van Berkhey [or Francq van Berkhij]	Franc van Berkhey [or Francq van Berkhij], Jan [Johannes] le	Franc van Berkhey, Jan le
Francoeur	Francoeur	Francoeur, Louis-Benjamin	Francoeur, Louis-Benjamin
Francoz	Francoz	Francoz, Claudius	Francoz, Claudius
F.Franke	Franke	Franke, Fritz	Franke, Fritz
Franqueville	Franqueville	Franqueville, Albert [comte] de	Franqueville, Albert de
Ed.François	François	François, Edmond	François, Edmond
François de Neufch.	François de Neufchâteau	François de Neufchâteau, Nicolas Louis (Comte de l Empire)	François de Neufchâteau, Nicolas Louis
T.R.Fraser	Fraser	Fraser, Thomas Richard (Sir)	Fraser, Thomas Richard
Fraude	Fraude	Fraude, Hermann	Fraude, Hermann
Frauenfeld	Frauenfeld	Frauenfeld, Georg [Ritter von]	Frauenfeld, Georg
Fray	Fray	Fray, Jean-Pierre (Abbé)	Fray, Jean-Pierre
Fraysse	Fraysse	Fraysse, A.	Fraysse, A.
Frazee	Frazee	Frazee, Louis Jacob	Frazee, Louis Jacob
W.G.Freeman	Freeman	Freeman, William George	Freeman, William George
M.Frei	Frei [-Sulzer]	Frei [-Sulzer], Max	Frei, Max
Frenguelli	Frenguelli	Frenguelli, Joaquín [b. Gioacchino]	Frenguelli, Joaquín
Frere	Frere	Frere, Bartle Henry Temple (Sir)	Frere, Bartle Henry Temple
E.Frickh.	Frickhinger	Frickhinger, Ernst Christoph	Frickhinger, Ernst Christoph
Frickhinger	Frickhinger	Frickhinger, Hermann	Frickhinger, Hermann
Frickhinger family	Frickhinger family	Frickhinger family.	Frickhinger family.
Fridtz	Fridtz	Fridtz, Randor Eretius	Fridtz, Randor Eretius
Friebel	Friebel	Friebel, Heinz	Friebel, Heinz
Friederich	Friederich	Friederich, Albert	Friederich, Albert
P.A.Friedrich	Friedrich	Friedrich, Paul Alexander	Friedrich, Paul Alexander
Friend	Friend	Friend, Hilderic (Rev.)	Friend, Hilderic
E.Th.Fr.	Fries	Fries, Elias Theodor [Thore] (a.k.a. Theodor Fries of Visby)	Fries, Elias Theodor
J.N.Friese	Friese	Friese, Johann Nepomuk [Nepomuck]	Friese, Johann Nepomuk
Frimmel	Frimmel	Frimmel, Franz von (a.k.a. Frimmel von Traisenau)	Frimmel, Franz von
Friren	Friren	Friren, Auguste [Marie Joseph] (Abbé)	Friren, Auguste
A.I.Frisch	Frisch	Frisch, Alban Immanuel	Frisch, Alban Immanuel
Frisendahl	Frisendahl	Frisendahl, Arvid	Frisendahl, Arvid
K.W.G.Fritsch	Fritsch	Fritsch, Karl [Carl] Wilhelm Georg (Freiherr) von	Fritsch, Karl Wilhelm Georg von
C.Froel.	Froelich	Froelich, Carl Fr.	Froelich, Carl Fr.
Fromentel	Fromentel	Fromentel, Louis Édouard Gourdan de	Fromentel, Louis Édouard Gourdan de
F.H.Frost	Frost	Frost, Frederick Hazard	Frost, Frederick Hazard
E.Fry	Fry	Fry, Edward (Sir)	Fry, Edward
Frémineau	Frémineau	Frémineau, Henri Fortuné	Frémineau, Henri Fortuné
Frödin	Frödin	Frödin, John Otto Henrik	Frödin, John Otto Henrik
C.A.Fuchs	Fuchs	Fuchs, Coelestin Anton (Pater)	Fuchs, Coelestin Anton
J.Fuchs	Fuchs	Fuchs, Josef (fl. 1866)	Fuchs, Josef
Jos.Fuchs	Fuchs	Fuchs, Josef (fl. 1911-1926)	Fuchs, Josef
M.Fuchs	Fuchs	Fuchs, Max	Fuchs, Max
Fuisting	Fuisting	Fuisting, Wilhelm [Guilelmus]	Fuisting, Wilhelm
Fullmer	Fullmer	Fullmer, Edward Lawrence	Fullmer, Edward Lawrence
Funke	Funke	Funke, George Lodewijk	Funke, George Lodewijk
W.Futterer	Futterer	Futterer, Wilhelm [Friedrich]	Futterer, Wilhelm
C.F.Förster	Förster	Förster, Carl Friedrich	Förster, Carl Friedrich
H.Förster	Förster	Förster, Hans	Förster, Hans
Gacogne	Gacogne	Gacogne, [Pierre Joseph] Alphonse	Gacogne, Alphonse
Gadow	Gadow	Gadow, Hans Friedrich [Friedrick]	Gadow, Hans Friedrich
Gaerdt	Gaerdt	Gaerdt, Heinrich	Gaerdt, Heinrich
P.Gaertn.	Gaertner	Gaertner, Philipp Gottfried	Gaertner, Philipp Gottfried
A.T.Gage	Gage	Gage, Andrew Thomas	Gage, Andrew Thomas
Gallardo	Gallardo	Gallardo, Ángel	Gallardo, Ángel
Gallenmüller	Gallenmüller	Gallenmüller, Joseph	Gallenmüller, Joseph
Gareiso	Gareiso	Gareiso, Joseph (Abbé)	Gareiso, Joseph
Gatin	Gatin	Gatin, Charles Louis	Gatin, Charles Louis
Gattefossé	Gattefossé	Gattefossé, Jean	Gattefossé, Jean
Gaud.	Gaudichaud-Beaupré	Gaudichaud-Beaupré, Charles	Gaudichaud-Beaupré, Charles
Gauthier-Lièvre	Gauthier-Lièvre	Gauthier-Lièvre, (Mme.) Lucienne Emilienne (née Lièvre)	Gauthier-Lièvre, Lucienne Emilienne
Gave	Gave	Gave, Pierre (Abbé)	Gave, Pierre
M.F.Geay	Geay	Geay, [Martin] François	Geay, François
Gedner	Gedner	Gedner, Christophor [Eliasson]	Gedner, Christophor
N.G.Gee	Gee	Gee, N[athaniel]. Gist	Gee, N. Gist
W.P.Gee	Gee	Gee, Wilson [Parham]	Gee, Wilson
A.J.C.Geerts	Geerts	Geerts, Antonius Johannes Cornelius	Geerts, Antonius Johannes Cornelius
K.Gehrmann	Gehrmann	Gehrmann, Karl [Carl] Anton	Gehrmann, Karl Anton
O.Geissler	Geissler	Geissler, Otto	Geissler, Otto
Geitl.	Geitler	Geitler, Lothar	Geitler, Lothar
Gellert	Gellert	Gellert, Magdalene	Gellert, Magdalene
Gelshorn	Gelshorn	Gelshorn, G.	Gelshorn, G.
Genlis	Genlis	Genlis, (Caroline) Stéphanie Félicité (née du Crest ...) (Comtesse de)	Genlis, Stéphanie Félicité
A.Georgii	Georgii	Georgii, Adolf	Georgii, Adolf
Gerke	Gerke	Gerke, Otto	Gerke, Otto
Gerndt	Gerndt	Gerndt, (Johann) Leonhard [Leonhardt]	Gerndt, Leonhard
Gertz	Gertz	Gertz, Otto Daniel	Gertz, Otto Daniel
Gevers Deynoot	Gevers Deynoot [Jonkheer]	Gevers Deynoot [Jonkheer], Pieter Marie Eduard	Gevers Deynoot, Pieter Marie Eduard
Gheorghieff	Gheorghieff [Georgiev]	Gheorghieff [Georgiev], Stefan [Stephan]	Gheorghieff, Stefan
W.Gibson	Gibson	Gibson, William Hamilton	Gibson, William Hamilton
Giesbrecht	Giesebrecht	Giesebrecht, Werner	Giesebrecht, Werner
Giger	Giger	Giger, Emil (Heinrich)	Giger, Emil
B.D.Gilbert	Gilbert	Gilbert, Benjamin Davis	Gilbert, Benjamin Davis
É.-J.Gilbert	Gilbert	Gilbert, Édouard-Jean	Gilbert, Édouard-Jean
Gill.	Gillet	Gillet, Claude [Casimir]	Gillet, Claude
Girod-Chantrans	Girod-Chantrans	Girod-Chantrans, Justin	Girod-Chantrans, Justin
Gislén	Gislén	Gislén, Torsten Rikard [Richard] Emanuel	Gislén, Torsten Rikard Emanuel
Glow.	Glowacki	Głowacki, Julius [Julij]	Głowacki, Julius
C.C.Gmelin	Gmelin	Gmelin, Carl [Karl] Christian	Gmelin, Carl Christian
J.F.Gmelin	Gmelin	Gmelin, Johann Friedrich	Gmelin, Johann Friedrich
J.G.Gmelin	Gmelin	Gmelin, Johann Georg	Gmelin, Johann Georg
P.F.Gmelin	Gmelin	Gmelin, Philipp Friedrich	Gmelin, Philipp Friedrich
S.G.Gmelin	Gmelin	Gmelin, Samuel Gottlieb	Gmelin, Samuel Gottlieb
Godfrin	Godfrin	Godfrin, Julien	Godfrin, Julien
K.C.T.Goebel	Goebel	Goebel, Karl Christian Traugott Friedemann	Goebel, Karl Christian Traugott Friedemann
Goepp.	Goeppert [Göppert]	Goeppert [Göppert], [Johann] Heinrich [Robert]	Goeppert, Heinrich
Goester	Goester	Goester, Leonard Emilius	Goester, Leonard Emilius
Gogela	Gogela	Gogela, Franz	Gogela, Franz
Goldenberg	Goldenberg	Goldenberg, Carl Friedrich	Goldenberg, Carl Friedrich
E.A.Goldman	Goldman	Goldman, Edward Alphonso (né Goltman)	Goldman, Edward Alphonso
Gombault	Gombault	Gombault, René	Gombault, René
Gombocz	Gombocz	Gombocz, Endre A.	Gombocz, Endre A.
Gomes f.	Gomes	Gomes, Bernardino António (filius)	Gomes, Bernardino António
Gonggrijp	Gonggrijp [Gonggryp]	Gonggrijp [Gonggryp], Justus Willem	Gonggrijp, Justus Willem
Gonnet	Gonnet	Gonnet, Philippe[-Prosper] Hilarion (Abbé)	Gonnet, Philippe Hilarion
Goodale	Goodale	Goodale, George Lincoln	Goodale, George Lincoln
Goodspeed	Goodspeed	Goodspeed, Thomas Harper (Harper)	Goodspeed, Thomas Harper
Gorschb.	Gorschboth	Gorschboth, Paul	Gorschboth, Paul
Gosselman	Gosselman(n)	Gosselman(n), Carl August	Gosselman, Carl August
Grabowski	Grabowski	Grabowski, Heinrich Emanuel	Grabowski, Heinrich Emanuel
R.Gradmann	Gradmann	Gradmann, Robert Julius Wilhelm	Gradmann, Robert Julius Wilhelm
Graebn.f.	Graebner	Graebner, Paul	Graebner, Paul
Grand.	Grandidier	Grandidier, Alfred	Grandidier, Alfred
G.Graves	Graves	Graves, George	Graves, George
S.F.Gray	Gray	Gray, Samuel Frederick	Gray, Samuel Frederick
Graëlls	Graëlls [Graells	Graëlls [Graells, Graélls] [y de la Agüera], Mariano de la Paz	Graëlls, Mariano de la Paz
C.T.Green	Green	Green, C[onrad]. Theodore	Green, C. Theodore
W.Greene	Greene	Greene, Wesley	Greene, Wesley
W.H.Gregg	Gregg	Gregg, William Henry	Gregg, William Henry
E.S.Gregory	Gregory	Gregory, Eliza Standerwick (née Barnes)	Gregory, Eliza Standerwick
W.Grevel	Grevel	Grevel, Wilhelm	Grevel, Wilhelm
Grevelink	Grevelink	Grevelink, Arnold Hermann Bisschop (a.k.a. Bisschop Grevelink, A.H.)	Grevelink, Arnold Hermann Bisschop
N.M.Grier	Grier	Grier, Norman MacDowell [McDowell]	Grier, Norman MacDowell
D.Griffiths	Griffiths	Griffiths, David	Griffiths, David
É.Griffon	Griffon	Griffon, Édouard	Griffon, Édouard
R.F.Griggs	Griggs	Griggs, Robert Fiske	Griggs, Robert Fiske
E.Grignon	Grignon	Grignon, Eugène	Grignon, Eugène
C.Grilli	Grilli	Grilli, Cesare	Grilli, Cesare
P.Grimbach	Grimbach	Grimbach, Peter	Grimbach, Peter
J.Grimm	Grimm	Grimm, Julius	Grimm, Julius
A.Grimme	Grimme	Grimme, Arnold [T.]	Grimme, Arnold
R.Grimwade	Grimwade	Grimwade, [Wilfrid] Russell (Sir)	Grimwade, Russell
D.H.Grindel	Grindel	Grindel, David Hieronymus [Heinrich]	Grindel, David Hieronymus
J.Grinţ.	Grintescu [Grintescu	Grinţescu [Grintescu, Grintzesco], Joan [Ioan, Ion, Jean, Johann]	Grinţescu, Joan
Grinţ.	Grintescu [Grintzescu]	Grinţescu [Grintzescu], Gheorghe [Georges P.]	Grinţescu, Gheorghe
A.Gris	Gris	Gris, [Jean Antoine] Arthur	Gris, Arthur
A.Grisch	Grisch	Grisch, Andreas	Grisch, Andreas
J.Groenland	Groenland [Grönland]	Groenland [Grönland], Johannes	Groenland, Johannes
Groff	Groff	Groff, G[eorge]. Weidman	Groff, G. Weidman
P.Groom	Groom	Groom, Percy	Groom, Percy
V.M.Grubb	Grubb	Grubb, Violet Margaret	Grubb, Violet Margaret
Grumm.	Grummann	Grummann, Vitus Johannes	Grummann, Vitus Johannes
L.Gruner	Gruner	Gruner, Leopold Fedorovich	Gruner, Leopold Fedorovich
Grész	Grész	Grész, János [Joannes, Johann, John, Jean]	Grész, János
J.Grøntved	Grøntved	Grøntved, Julius	Grøntved, Julius
Gubb	Gubb	Gubb, Alfred Samuel (M.D.)	Gubb, Alfred Samuel
Guilfoyle	Guilfoyle	Guilfoyle, William Robert	Guilfoyle, William Robert
Guillaud	Guillaud	Guillaud, Jean-Alexandre	Guillaud, Jean-Alexandre
Guillaume	Guillaume	Guillaume, André	Guillaume, André
Gunn.	Gunnerns	Gunnerns, Johan Ernst	Gunnerns, Johan Ernst
Guppy	Guppy	Guppy, Henry Brougham	Guppy, Henry Brougham
Gusul.	Gusuleac	Guşuleac, Mihail [Michail]	Guşuleac, Mihail
A.H.Guyot	Guyot	Guyot, Arnaud [Arnold] Henri [Henry]	Guyot, Arnaud Henri
H.Guyot	Guyot	Guyot, Henry	Guyot, Henry
H.C.I.Gwynne-Vaughan	Gwynne-Vaughan	Fraser, Helen Charlotte Isabella, see Gwynne-Vaughan	Fraser, Helen Charlotte Isabella, see Gwynne-Vaughan
Görz	Görz	Görz, Rudolf	Görz, Rudolf
O.Hahn	Hahn	Hahn, Otto	Hahn, Otto
F.Hall	Hall	Hall, Franklin Wilson	Hall, Franklin Wilson
J.Halle	Halle	Halle, Johann Samuel	Halle, Johann Samuel
H.Hallier	Hallier	Hallier, Hans [Johannes] Gottfried	Hallier, Hans Gottfried
F.Ham.	Hamilton	Hamilton, Francis (né Buchanan)	Hamilton, Francis
W.Ham.	Hamilton	Hamilton, William	Hamilton, William
Hammerschmid	Hammerschmid	Hammerschmid, Anton	Hammerschmid, Anton
C.Hans.	Hansen	Hansen, Carl	Hansen, Carl
E.Hans.	Hansen	Hansen, Emil Christian	Hansen, Emil Christian
G.Hans.	Hansen	Hansen, George	Hansen, George
H.Hans.	Hansen	Hansen, Hans Marius Mølholm	Hansen, Hans Marius Mølholm
L.Hans.	Hansen	Hansen, Lars	Hansen, Lars
H.Hanst.	Hanstein	Hanstein, Heinrich	Hanstein, Heinrich
J.Hanst.	Hanstein	Hanstein, Johannes Ludwig Emil Robertvon	Hanstein, Johannes Ludwig Emil Robertvon
Hao	Hao	Hao, Kin-Shen [Ching-shêng Ho]	Hao, Kin-Shen
K.Hara	Hara	Hara, Kanesuke	Hara, Kanesuke
R.Hartm.	Hartman	Hartman, Robert Wilhelm	Hartman, Robert Wilhelm
F.Hartmann	Hartmann	Hartmann, Frans Xaver, Ritter von	Hartmann, Frans Xaver, Ritter von
Harv.-Gib.	Harvey-Gibson	Harvey-Gibson, Robert John	Harvey-Gibson, Robert John
C.Harz	Harz	Harz, Carl [Karl] Otto	Harz, Carl Otto
J.Hasselt	Hasselt	Hasselt, Johan Coenraad van	Hasselt, Johan Coenraad van
Haum.	Hauman	Hauman, Lucien	Hauman, Lucien
W.Hay	Hay	Hay, William Delisle	Hay, William Delisle
G.Heim	Heim	Heim, Georg Christoph	Heim, Georg Christoph
H.Hein	Hein	Hein, Heinrich	Hein, Heinrich
T.Hein	Hein	Hein, Theodor	Hein, Theodor
Helw.	Helwing	Helwing, Georg Andreas	Helwing, Georg Andreas
Hemp.	Hempel	Hempel, Gustav	Hempel, Gustav
N.Henderson	Henderson	Henderson, Nellie Frater	Henderson, Nellie Frater
Henr.	Henrard	Henrard, Jan Theodor	Henrard, Jan Theodor
J.Hensl.	Henslow	Henslow, John Stevens	Henslow, John Stevens
A.Herv.	Hervey	Hervey, Alpheus Baker	Hervey, Alpheus Baker
E.Herv.	Hervey	Hervey, Eliphalet Williams	Hervey, Eliphalet Williams
Herz.	Herzog	Herzog, Theodor [Carl Julius]	Herzog, Theodor
Higl.	Higley	Higley, William Kerr	Higley, William Kerr
Hiit.	Hiitonen	Hiitonen, Henrik Ilmari Augustus (up till 1932 Hidén)	Hiitonen, Henrik Ilmari Augustus
J.Hill	Hill	Hill, John	Hill, John
Hillm.	Hillmann	Hillmann, Johannes	Hillmann, Johannes
Himp.	Himpel	Himpel, J. Stephan	Himpel, J. Stephan
Hiratsuka	Hiratsuka	Hiratsuka, Naohide	Hiratsuka, Naohide
C.Hitchc.	Hitchcock	Hitchcock, Charles Leo	Hitchcock, Charles Leo
Hitchc	Hitchcock	Hitchcock, Albert Spear (né Jennings)	Hitchcock, Albert Spear
Hjaltalín	Hjaltalín	Hjaltalín, Oddur Jönsson	Hjaltalín, Oddur Jönsson
Hobs.	Hobson	Hobson, Edward	Hobson, Edward
J.Hoek	Hoek	Hoek, Julie L., later Redeke-Hoek	Hoek, Julie L., later Redeke-Hoek
Hoess	Hoess	Hoess, Franz	Hoess, Franz
Hofm.B.	Hofman Bang	Hofman Bang, Niels	Hofman Bang, Niels
J.Holm	Holm	Holm, Jørgen Tyche (Georg Tycho)	Holm, Jørgen Tyche
J.D.Hook.	Hooker	Hooker, Joseph Dalton	Hooker, Joseph Dalton
J.Hope	Hope	Hope, John	Hope, John
Horsf	Horsfield	Horsfield, Thomas	Horsfield, Thomas
Hovel	Hovelacque	Hovelacque, Maurice Jean Alexandre	Hovelacque, Maurice Jean Alexandre
E.Howe	Howe	Howe, Elliot Calvin	Howe, Elliot Calvin
Hubb.	Hubbard	Hubbard, Charles Edward	Hubbard, Charles Edward
E.Huet	Huet du Pavillon	Huet du Pavillon, Édouard	Huet du Pavillon, Édouard
W.Hunt	Hunt	Hunt, Willis Roberts	Hunt, Willis Roberts
Hussey.	Hussey	Hussey, A. M.(née Reed; Mrs. Thomas Jonathan Hussey)	Hussey, A. M.
Häyr.	Häyren	Häyren, Ernst Fredrik	Häyren, Ernst Fredrik
Höeg	Höeg	Höeg, Ove Arbo	Höeg, Ove Arbo
Hóppner	Höppner	Höppner, Hans	Höppner, Hans
Hueb.	Hübener	Hübener, Johann Wilhelm Peter	Hübener, Johann Wilhelm Peter
Ingh.	Ingham	Ingham, William	Ingham, William
Issl.	Issler	Issler, Émile (Emil)	Issler, Émile
K.Ito	Ito	Ito, Keisuke	Ito, Keisuke
T.Ito	Ito	Ito, Tokutaro	Ito, Tokutaro
W.Jack	Jack	Jack, William	Jack, William
G.Jacks.	Jackson	Jackson, George	Jackson, George
H.Jacks.	Jackson	Jackson, Herbert Spencer	Jackson, Herbert Spencer
J.Jacks	Jackson	Jackson, Joseph	Jackson, Joseph
V.Jacks.	Jackson	Jackson, Vincent Wilson	Jackson, Vincent Wilson
A.Jaeg.	Jaeger	Jaeger, August	Jaeger, August
E.Jaeg.	Jaeger	Jaeger, Edmund Carroll	Jaeger, Edmund Carroll
G.Jaeg.	Jaeger	Jaeger, Georg Friedrich [von]	Jaeger, Georg Friedrich
A.F.Jahn	Jahn	Jahn, August Friedrich Wilhelm Ernst	Jahn, August Friedrich Wilhelm Ernst
T.James	James	James, Thomas Potts	James, Thomas Potts
Jans.	Jansen	Jansen, Pieter	Jansen, Pieter
Jao	Jao	Jao, Chin-chih	Jao, Chin-chih
Jaume St.-Hil.	Jaume Saint-Hilaire	Jaume Saint-Hilaire, Jean Henri	Jaume Saint-Hilaire, Jean Henri
E.Jeffr.	Jeffrey	Jeffrey, Edward Charles	Jeffrey, Edward Charles
J.Jeffr.	Jeffrey	Jeffrey, John	Jeffrey, John
Jenkins.	Jenkinson	Jenkinson, James	Jenkinson, James
Jenm.	Jenman	Jenman, George Samuel	Jenman, George Samuel
C.Jens.	Jensen	Jensen, Christian Erasmus Otterstrøm	Jensen, Christian Erasmus Otterstrøm
T.Jens.	Jensen	Jensen, Thomas	Jensen, Thomas
J.Jiras.	Jirasek	Jirasek, Jan [Johann]	Jirasek, Jan
Johann Baptist	Johann Baptist	Johann Baptist, Fabian Sebastian, Archduke of Austria	Johann Baptist, Fabian Sebastian, Archduke of Austria
A.M.Johns.	Johnson	Johnson, Arthur Monrad	Johnson, Arthur Monrad
C.Johns.	Johnson	Johnson, Charles	Johnson, Charles
C.P.Johns.	Johnson	Johnson, Charles Pierpont	Johnson, Charles Pierpont
L.Johns.	Johnson	Johnson, Lorenz(o) Nickerson	Johnson, Lorenz Nickerson
T.Johns.	Johnson	Johnson, Thomas	Johnson, Thomas
W.Johns.	Johnson	Johnson, William	Johnson, William
G.Johnst.	Johnston	Johnston, George	Johnston, George
R.Johnst.	Johnston	Johnston, Robert Mackenzie	Johnston, Robert Mackenzie
Jonk.	Jonker	Jonker, Fredrik Pieter	Jonker, Fredrik Pieter
Juge St.Mart.	Juge de Saint Martin	Juge de Saint Martin, Jacques Joseph	Juge de Saint Martin, Jacques Joseph
Jumelle	Jumelle	Jumelle, Henri (Lucien)	Jumelle, Henri
Adr.Juss.	Jussieu	Jussieu, Adrien Henri Laurent de	Jussieu, Adrien Henri Laurent de
Jörg.	Jörgensen	Jörgensen, Eugen Honoratius	Jörgensen, Eugen Honoratius
Jörl	Jörlin	Jörlin, Engelbert	Jörlin, Engelbert
Jörst.	Jørstad	Jørstad, Ivar	Jørstad, Ivar
Kablik	Kablíková	Kablíková, Josephine [Josefina], née Ettel, [Josephine Kablik]	Kablíková, Josephine, née Ettel
Kab.	Kabát	Kabát, Josef Emanuel	Kabát, Josef Emanuel
Kamiénski	Kamiénski	Kamiénski, Frans (Franciszek)	Kamiénski, Frans
Karel.	Karelin	Karelin, Grigorij Silyc (Gregor Silitsch, Silovitsch).	Karelin, Grigorij Silyc
Kash.	Kashyap	Kashyap, Shiv Ram	Kashyap, Shiv Ram
Kaur.	Kaurin	Kaurin, Christian	Kaurin, Christian
Kearn.	Kearney	Kearney, Thomas Henry	Kearney, Thomas Henry
D.Keck	Keck	Keck, David Daniels	Keck, David Daniels
K.Keck	Keck	Keck, Karl	Keck, Karl
H.Kelly	Kelly	Kelly, Howard Atwood	Kelly, Howard Atwood
J.D.Kennedy	Kennedy	Kennedy, James Domoné	Kennedy, James Domoné
J.Kennedy	Kennedy	Kennedy, John	Kennedy, John
W.S.Kent	Kent	Kent, William Saville	Kent, William Saville
Ker-Gawl.	Ker	Ker, John Bellenden	Ker, John Bellenden
A.Kern	Kerner von Marilaun	Kerner von Marilaun, Anton Joseph, Ritter	Kerner von Marilaun, Anton Joseph, Ritter
Kessel	Kessel	Kessel, Stephen Lackey	Kessel, Stephen Lackey
J.Kickx fil.	Kickx	Kickx, Jean, Jr.	Kickx, Jean, Jr.
Kirillow	Kirillow	Kirillow, Peter	Kirillow, Peter
T.Kirk	Kirk	Kirk, Thomas	Kirk, Thomas
Klebs	Klebs	Klebs, Georg Albrecht	Klebs, Georg Albrecht
J.L.Knapp	Knapp	Knapp, John Leonard	Knapp, John Leonard
J.Knight	Knight	Knight, Joseph	Knight, Joseph
G.Knowles	Knowles	Knowles, George Beauchamp	Knowles, George Beauchamp
K.Koch Osnabr.	Koch	Koch, Karl	Koch, Karl
Koerb.	Koerber (Körber)	Koerber (Körber), Gustav Wilhelm	Koerber, Gustav Wilhelm
Kof	Kofoid	Kofoid, Charles Atwood	Kofoid, Charles Atwood
Kölb.	Kolbing	Kolbing, F, W.	Kolbing, F, W.
Korshinsky	Korshinsky [Koržinskij]	Korshinsky [Koržinskij], Sergei Iwanowitsch	Korshinsky, Sergei Iwanowitsch
Kral.	Kralik	Kralik, Jean-Louis	Kralik, Jean-Louis
F.Kram.	Kramer	Kramer, Franz August	Kramer, Franz August
W.Kram.	Kramer	Kramer, Wilhelm Heinrich	Kramer, Wilhelm Heinrich
J.Krauss	Krauss	Krauss, Johan Carl	Krauss, Johan Carl
L.Krebs	Krebs	Krebs, (Georg) Ludwig Englehard	Krebs, Ludwig Englehard
Kreutz.	Kreutzer	Kreutzer, Karl (Carl) Joseph	Kreutzer, Karl Joseph
K.Krieg.	Krieger	Krieger, Karl Wilhelm	Krieger, Karl Wilhelm
Kräus.	Kräusel	Kräusel, Richard	Kräusel, Richard
F.Kurtz	Kurtz	Kurtz, Fritz (Frederico)	Kurtz, Fritz
Köhl.	Köhler	Köhler, Hermann Adolph	Köhler, Hermann Adolph
J.König	König	König, Johann Gerhard	König, Johann Gerhard
Köpp.	Köppen	Köppen, Friedrich Theodor (Petrowitsch) von	Köppen, Friedrich Theodor von
Kühn	Kühn	Kühn, Julius Gotthelf	Kühn, Julius Gotthelf
Kükenth.	Kükenthal	Kükenthal, Georg	Kükenthal, Georg
L'Herminier	L'Herminier	LHerminier, Ferdinand	LHerminier, Ferdinand
Lacr.	Lacroix	Lacroix, Louis-Sosthène Veyron de	Lacroix, Louis-Sosthène Veyron de
Lagerberg	Lagerberg	Lagerberg, Karl Erik Torsten	Lagerberg, Karl Erik Torsten
Lamb	Lamb	Lamb, Ivan Mackenzie, later Elke Mackenzie	Lamb, Ivan Mackenzie, later Elke Mackenzie
Lams.-Scribn.	Lamson-Scribner	Lamson-Scribner, Frank (originally Franklin Pierce Lamson)	Lamson-Scribner, Frank
Langer.	Langeron	Langeron, Maurice Charles Pierre	Langeron, Maurice Charles Pierre
Laph.	Lapham	Lapham, Increase Allen	Lapham, Increase Allen
Lauvergne	Lauvergne	Lauvergne, Hubert	Lauvergne, Hubert
Lavall.	Lavallée	Lavallée, Pierre Alphonse Martin	Lavallée, Pierre Alphonse Martin
G.Lawr.	Lawrence	Lawrence, George Hill Mathewson	Lawrence, George Hill Mathewson
C.Laws.	Lawson	Lawson, Charles	Lawson, Charles
G.Laws.	Lawson	Lawson, George	Lawson, George
M.A.Laws.	Lawson	Lawson, Marmaduke Alexander	Lawson, Marmaduke Alexander
E.Lees	Lees	Lees, Edwin	Lees, Edwin
Lefr.	Lefroy	Lefroy, Sir John Henry	Lefroy, Sir John Henry
Lefèv.	Lefèvre	Lefèvre, Édouard	Lefèvre, Édouard
Legrand	Legrand	Legrand, Antoine	Legrand, Antoine
A.Lehm.	Lehmann	Lehmann, August	Lehmann, August
Ed.Lehm.	Lehmann	Lehmann, Eduard (also Leman, Eduard Eduardovich)	Lehmann, Eduard
Ernst Lehm.	Lehmann	Lehmann, Ernst	Lehmann, Ernst
Leibl.	Leibling	Leibling, Otto	Leibling, Otto
Leim.	Leimer	Leimer, Franz	Leimer, Franz
Lein.	Leiner	Leiner, Ludwig	Leiner, Ludwig
Lelièvre	Lelièvre	Lelièvre, J. F.	Lelièvre, J. F.
E.Leonard	Leonard	Leonard, Emery Clarence	Leonard, Emery Clarence
Leonhardi	Leonhardi	Leonhardi, Peter Carl Pius Gustav Hermann, Freiherr von [Hermann von L.]	Leonhardi, Peter Carl Pius Gustav Hermann, Freiherr von
Leszc.-Sum.	Leszczyc-Suminsky	Leszczyc-Suminsky, Michael Hieronim	Leszczyc-Suminsky, Michael Hieronim
Li	Li	Li, Hui-Lin	Li, Hui-Lin
Licopoli	Licopoli	Licopoli, Gaetano	Licopoli, Gaetano
Liljebl.	Liljeblad	Liljeblad, Samuel	Liljeblad, Samuel
Linczevski	Linczevski	Linczevski, Igorj Alexandrovicz	Linczevski, Igorj Alexandrovicz
L.fil.	Linné	Linné, Carl von, filius	Linné, Carl von, filius
E.Linton	Linton	Linton, Edward Francis	Linton, Edward Francis
W.J.Linton	Linton	Linton, William James	Linton, William James
Lipp.	Lipp	Lipp, Franz Joseph	Lipp, Franz Joseph
G.List.	Lister	Lister, Guilielma	Lister, Guilielma
List.	Lister	Lister, Arthur	Lister, Arthur
Liu	Liu	Liu, Ju-chiang	Liu, Ju-chiang
C.G.Lloyd	Lloyd	Lloyd, Curtis Gates	Lloyd, Curtis Gates
E.Loew	Loew	Loew, Ernst	Loew, Ernst
H.Lohwag	Lohwag	Lohwag, Heinrich	Lohwag, Heinrich
W.H.Long	Long	Long, William Henry	Long, William Henry
Lonic.	Lonitzer [Lonicerus]	Lonitzer [Lonicerus], Adam	Lonitzer, Adam
Lopriore	Lopriore (Lo Priore)	Lopriore (Lo Priore), Giuseppe	Lopriore, Giuseppe
H.Loret	Loret	Loret, Henri	Loret, Henri
F.Lorey	Lorey	Lorey, Félix-Nicolas	Lorey, Félix-Nicolas
C.Lortet	Lortet	Lortet, Mme. Clémence, née Richard	Lortet, Mme. Clémence, née Richard
J.W.Loud.	Loudon	Loudon, Jane Wells (née Webb)	Loudon, Jane Wells
Loud.	Loudon	Loudon, John Claudius	Loudon, John Claudius
R.Lowe	Lowe	Lowe, Richard Thomas	Lowe, Richard Thomas
Luis.	Luisier	Luisier, Alphonse	Luisier, Alphonse
Lukmanoff	Lukmanoff	Lukmanoff, Athanase de	Lukmanoff, Athanase de
C.Lundell	Lundell	Lundell, Cyrus Longworth	Lundell, Cyrus Longworth
P.Lundell.	Lundell	Lundell, Peter Magnus [Manne]	Lundell, Peter Magnus
Lundqvist	Lundqvist	Lundqvist, [Adolf] Gösta	Lundqvist, Gösta
A.Luther	Luther	Luther, Alexander Ferdinand	Luther, Alexander Ferdinand
I.Lyons	Lyons	Lyons, Israel	Lyons, Israel
A.Láng	Láng	Láng, Adolf Franz [Franz Adolf, Adolph]	Láng, Adolf Franz
Lazaro	Lázaro é Ibiza	Lázaro é Ibiza, Blas	Lázaro é Ibiza, Blas
Léon	Léon	Léon, Frère [Sauget y Barbis, Joseph Sylvestre], [Hermano Léon]	Léon, Frère
Lönnegren	Lönnegren	Lönnegren, August Valfrid	Lönnegren, August Valfrid
K.Lönnroth	Lönnroth	Lönnroth, Knut Johan	Lönnroth, Knut Johan
Lörch	Lörch	Lörch, Ph, J.	Lörch, Ph, J.
G.Lützow	Lützow	Lützow, G.	Lützow, G.
M'Andrew	M'Andrew [McAndrew]	MAndrew [McAndrew], James	MAndrew, James
M'Clell.	M'Clelland [McClelland]	MClelland [McClelland], John	MClelland, John
M'Ken	M'Ken [McKen	MKen [McKen, Mac Kerc], Mark John	MKen, Mark John
Maas G.	Maas Geesteranus	Maas Geesteranus, Rudolf Arnold	Maas Geesteranus, Rudolf Arnold
Mac Leod	Mac Leod	Mac Leod, Julius	Mac Leod, Julius
T.MacDougall	MacDougall	MacDougall, Thomas Baillie	MacDougall, Thomas Baillie
J.MacGillivray	MacGillivray	MacGillivray, John	MacGillivray, John
P.MacGillivray	MacGillivray	MacGillivray, Paul Howard	MacGillivray, Paul Howard
W.MacGillivray	MacGillivray	MacGillivray, William	MacGillivray, William
W.Macarthur	Macarthur	Macarthur, (Sir) William	Macarthur, William
Macbr.	Macbride	Macbride, James Francis	Macbride, James Francis
MISSING-Macedo.	Macedo	Macedo, [Manuel] Antonio de	Macedo, Antonio de
Macfady.	Macfadyen	Macfadyen, James	Macfadyen, James
Mach.	Machado Guimaraes	Machado Guimaraes, António Luis	Machado Guimaraes, António Luis
Mackenz.	Mackenzie	Mackenzie, Kenneth Kent	Mackenzie, Kenneth Kent
Magnusson	Magnusson	Magnusson, Adolf Hugo	Magnusson, Adolf Hugo
Malacarne	Malacarne	Malacarne, Claro Giuseppe	Malacarne, Claro Giuseppe
X.Manetti	Manetti	Manetti, Xaverio [Saverio]	Manetti, Xaverio
Manganotti	Manganotti	Manganotti, Antonio	Manganotti, Antonio
Mansion	Mansion	Mansion, Arthur	Mansion, Arthur
Él.Marchal	Marchal	Marchal, Élie	Marchal, Élie
Ém.Marchal	Marchal	Marchal, Émile Jules Joseph	Marchal, Émile Jules Joseph
Marie-Vict.	Marie-Victorin	Marie-Victorin, Frère [Joseph Louis Conrad Kirouac]	Marie-Victorin, Frère
C.Marquart	Marquart	Marquart, Clamor Ludwig	Marquart, Clamor Ludwig
M.-Bieb.	Marschall von Bieberstein	Marschall von Bieberstein, Friedrich August, Freiherr	Marschall von Bieberstein, Friedrich August, Freiherr
E.Marsh.	Marshall	Marshall, [Rev.] Edward Shearburn	Marshall, Edward Shearburn
J.Marsh.	Marshall	Marshall, Joseph Jewison	Marshall, Joseph Jewison
Marsh.	Marshall	Marshall, Humphry	Marshall, Humphry
N.Marsh.	Marshall	Marshall, [Caroline] Nina Lovering	Marshall, Nina Lovering
R.Marsh.	Marshall	Marshall, Reginald Charles	Marshall, Reginald Charles
W.Marsh.	Marshall	Marshall, William	Marshall, William
Martersteck	Martersteck	Martersteck, Johann Clemens	Martersteck, Johann Clemens
W.K.Martin	Martin	Martin, William Keble	Martin, William Keble
I.C.Martindale	Martindale	Martindale, Isaac Comly	Martindale, Isaac Comly
J.A.Martindale	Martindale	Martindale, Joseph Anthony	Martindale, Joseph Anthony
Martinez	Martinez	Martinez, Maximino	Martinez, Maximino
Marzari-Pencati	Marzari-Pencati	Marzari-Pencati, Giuseppe, Conte	Marzari-Pencati, Giuseppe, Conte
F.Mason	Mason	Mason, Francis	Mason, Francis
W.Mathews	Mathews	Mathews, William	Mathews, William
Mattuschka	Mattuschka	Mattuschka, Heinrich Gottfried, Graf von	Mattuschka, Heinrich Gottfried, Graf von
H.Maurer	Maurer	Maurer, Heinrich [Ludwig]	Maurer, Heinrich
Maxim.Wied	Maximilian Alexander Philipp	Maximilian Alexander Philipp, Prinz zu Wied-Neuwied	Maximilian Alexander Philipp, Prinz zu Wied-Neuwied
Maxim.-Ambodik	Maximowicz-Ambodik	Maximowicz-Ambodik, Nestor	Maximowicz-Ambodik, Nestor
Mayebara	Mayebara	Mayebara, [Maehara], Kanjiro	Mayebara, Kanjiro
Ad.T.Mayer	Mayer	Mayer, Adolf Theodor	Mayer, Adolf Theodor
An.Mayer	Mayer	Mayer, Anton	Mayer, Anton
J.Mayer prag.	Mayer	Mayer, Johann	Mayer, Johann
W.McCalla	McCalla [M'Calla]	McCalla [MCalla], William	McCalla, William
McClat.	McClatchie	McClatchie, Alfred James	McClatchie, Alfred James
McKelv.	McKelvey	McKelvey, Susan Adams (née Delano [Mrs. Charles Wylie McKelvey, 1907]	McKelvey, Susan Adams
Mc Vaugh	McVaugh	McVaugh, Rogers	McVaugh, Rogers
F.N.Meyer	Meijer	Meijer, Frans Nicholaas (after 1908 Frank Nicholas Meyer)	Meijer, Frans Nicholaas
Melsheimer	Melsheimer	Melsheimer, Marcellus	Melsheimer, Marcellus
Memminger	Memminger	Memminger, Edward Read	Memminger, Edward Read
Metzl.	Metzler	Metzler, Jakob Adolf (H)	Metzler, Jakob Adolf
Meulenhoff	Meulenhoff	Meulenhoff, J. S.	Meulenhoff, J. S.
F.Michx	Michaux	Michaux, François-André	Michaux, François-André
M.Mich.	Micheli	Micheli, Marc	Micheli, Marc
P.Mich.	Micheli	Micheli, Pier Antonio (Pietro Antonio)	Micheli, Pier Antonio
J.C Mikan	Mikan	Mikan, Johann Christian	Mikan, Johann Christian
Miliarakis	Miliarakis	Miliarakis, Spyridon	Miliarakis, Spyridon
Millard.	Millardet	Millardet, Pierre Marie Alexis	Millardet, Pierre Marie Alexis
Minà-Palumbo	Minà-Palumbo	Minà-Palumbo, Francesco	Minà-Palumbo, Francesco
J.Mitch.Stanst.	Mitchell	Mitchell, John (of Stanstead, Sussex)	Mitchell, John
Miégeville	Miégeville	Miégeville, Joseph	Miégeville, Joseph
N.Moe	Moe	Moe, Nils Green	Moe, Nils Green
N.Mohr	Mohr	Mohr, Nicolai (i Pedersen)	Mohr, Nicolai
D.Moore	Moore	Moore, David (until 1828 Muir)	Moore, David
Morg.	Morgan	Morgan, Andrew Price	Morgan, Andrew Price
Morgenroth	Morgenroth	Morgenroth, Eduard	Morgenroth, Eduard
A.Mori	Mori	Mori, Antonio	Mori, Antonio
C.Morr.	Morren	Morren, Charles François Antoine	Morren, Charles François Antoine
E.Morr.	Morren	Morren, Charles Jacques Édouard	Morren, Charles Jacques Édouard
J.Morris	Morris	Morris, John	Morris, John
H.Mortensen	Mortensen	Mortensen, Hans	Mortensen, Hans
M.Mortensen	Mortensen	Mortensen, Morten Larsen	Mortensen, Morten Larsen
C.Morton	Morton	Morton, Conrad Vernon	Morton, Conrad Vernon
V.Mouton	Mouton	Mouton, Victor	Mouton, Victor
Moxl.	Moxley	Moxley, George Loucks	Moxley, George Loucks
F.v.Muell.	Mueller	Mueller, Sir Ferdinand Jacob Heinrich (Baron) von	Mueller, Sir Ferdinand Jacob Heinrich von
J.B.Müll	Mueller	Mueller, Jean Baptiste [Baptista]	Mueller, Jean Baptiste
Jos.Muell.	Mueller	Mueller, Joseph M.	Mueller, Joseph M.
K.Muell.berol.	Mueller	Mueller, Karl (Carl)	Mueller, Karl
W.Muell.Stettin	Mueller	Mueller, Wilhelm	Mueller, Wilhelm
C.Mull.	Muller [before 1937: Mueller]	Muller [before 1937 Mueller], Cornelius Herman	Muller, Cornelius Herman
Andr.Murray	Murray	Murray, Andrew	Murray, Andrew
J.A.Murray	Murray	Murray, Johan Andreas (Anders)	Murray, Johan Andreas
Mulis	Mutis y Bosio	Mutis y Bosio, José Célestino Bruno	Mutis y Bosio, José Célestino Bruno
H.Möller	Möller	Möller, Hjalmar August	Möller, Hjalmar August
Mühlenbach	Mühlenbach	Mühlenbach, Viktor	Mühlenbach, Viktor
Fritz Müll.	Müller	Müller, Fritz [Johann Friedrich Theodor]	Müller, Fritz
H.Müll.-Thurg.	Müller	Müller, (Thurgau), Herman	Müller, Herman
K.Müll.frib.	Müller	Müller, Karl	Müller, Karl
K.Müll.hal.	Müller	Müller, Johann Karl [Carl] August [Friedrich Wilhelm]	Müller, Johann Karl August
Th.Müll.	Müller	Müller, Theodor	Müller, Theodor
G.Münster	Münster	Münster, Georg Graf zu	Münster, Georg Graf zu
Nachtigal	Nachtigal	Nachtigal, Gustav Hermann	Nachtigal, Gustav Hermann
Nattras	Nattras	Nattras, Roland Marshall	Nattras, Roland Marshall
Nawaschin	Nawaschin	Nawaschin, Sergius Gawrilowitsch [Navashin, Sergei, Gavrilovich]	Nawaschin, Sergius Gawrilowitsch
A.Neal	Neal	Neal, Adam	Neal, Adam
A.Nels.	Nelson	Nelson, Aven	Nelson, Aven
D.Nels.	Nelson	Nelson, David	Nelson, David
E.E.Nels.	Nelson	Nelson, Elias Emanuel	Nelson, Elias Emanuel
E.M.Nels.	Nelson	Nelson, Edward Milles	Nelson, Edward Milles
E.W.Nels.	Nelson	Nelson, Edward William	Nelson, Edward William
J.Nels.	Nelson	Nelson, John (Senilis)	Nelson, John
Nemec	Nemec	Nemec, Bohumil Rehor	Nemec, Bohumil Rehor
F.Němejc	Nemejc	Němejc, František	Němejc, František
F.C.Newcombe	Newcombe	Newcombe, Frederick Charles	Newcombe, Frederick Charles
Newh.	Newhall	Newhall, Charles Stedman	Newhall, Charles Stedman
F.Newm.	Newman	Newman, Francis William	Newman, Francis William
Newm.	Newman	Newman, Edward	Newman, Edward
I.Newton	Newton	Newton, Isaac	Newton, Isaac
G.Nichols.	Nicholson	Nicholson, George	Nicholson, George
H.Nichols.	Nicholson	Nicholson, Henry Alleyne	Nicholson, Henry Alleyne
W.A.Nichols.	Nicholson	Nicholson, William Alexander	Nicholson, William Alexander
W.E.Nichols.	Nicholson	Nicholson, William Edward	Nicholson, William Edward
Nicols.	Nicolson	Nicolson, (Père)	Nicolson
P.Nielsen	Nielsen	Nielsen, Peter	Nielsen, Peter
Niethammer	Niethammer	Niethammer, Anneliese	Niethammer, Anneliese
G.Nilsson, Degel.	Nilsson	Nilsson, Gunnar Bror Fritiof (Nilsson-Degelius, G.B.F., Degelius, G.B.F.)	Nilsson, Gunnar Bror Fritiof
N.Nilsson	Nilsson	Nilsson, Nils Hjalmar	Nilsson, Nils Hjalmar
C.Noel	Noel	Noel, Charles William Francis, 3rd earl of Gainsborough	Noel, Charles William Francis, 3rd earl of Gainsborough
Nolle	Nolte	Nolte, Ernst Ferdinand	Nolte, Ernst Ferdinand
Nordenskiöld	Nordenskiöld	Nordenskiöld, [Nils] Adolph Erik [von]	Nordenskiöld, Adolph Erik
G.Norm.	Norman	Norman, George	Norman, George
Norm.	Norman	Norman, Johannes Musaeus	Norman, Johannes Musaeus
Noroña	Noroña	Noroña, Francisco (Noronha, François; also err. Fernando)	Noroña, Francisco
E.Nym.	Nyman	Nyman, Erik Olof August	Nyman, Erik Olof August
Nym.	Nyman	Nyman, Carl Fredrik	Nyman, Carl Fredrik
Nábelek	Nábelek	Nábelek, František	Nábelek, František
Näg.	Nägeli	Nägeli, Carl Wilhelm [von], [Naegeli]	Nägeli, Carl Wilhelm
O.Näg.	Nägeli	Nägeli, Otto	Nägeli, Otto
C.O'brien	O'Brien	OBrien, Charlotte Grace	OBrien, Charlotte Grace
O'Don.	O'Donell	ODonell, Carlos Alberto	ODonell, Carlos Alberto
Oborný	Oborný	Oborný, Adolf	Oborný, Adolf
Oed.	Oeder	Oeder, George Christian [von Oldenburg]	Oeder, George Christian
Oehninger	Oehninger	Oehninger, Carl Johannes	Oehninger, Carl Johannes
Okam.	Okamura	Okamura, Kintarô	Okamura, Kintarô
S.Okam.	Okamura	Okamura, Shûtai	Okamura, Shûtai
F.Oliver	Oliver	Oliver, Francis Wall	Oliver, Francis Wall
Oliver	Oliver	Oliver, Daniel	Oliver, Daniel
W.Oliver	Oliver	Oliver, Walter Reginald Brook	Oliver, Walter Reginald Brook
P.Olsson, Skåne	Olsson	Olsson, Peter [Petter]	Olsson, Peter
P.Olsson, Värml.	Olsson	Olsson, Peter	Olsson, Peter
OlssonSeffer	Olsson-Seffer	Olsson-Seffer, Pehr Hjalmar (until 1903 P. H. Olsson)	Olsson-Seffer, Pehr Hjalmar
Oppenheimer	Oppenheimer	Oppenheimer, Hillel [Heinz] Reinhard	Oppenheimer, Hillel Reinhard
A.D.d'Orb.	Orbigny	Orbigny, Alcide Dessalines d	Orbigny, Alcide Dessalines d
C.d'Orb.	Orbigny	Orbigny, [Alcide] Charles Victor Dessalines d	Orbigny, Charles Victor Dessalines d
Orc utt	Orcutt	Orcutt, Charles Russell	Orcutt, Charles Russell
Ormezzano	Ormezzano	Ormezzano, Quentin Jean Baptiste	Ormezzano, Quentin Jean Baptiste
J.Gonz.Ort.	Ortega	Ortega, Jesús González	Ortega, Jesús González
Ort.	Ortega	Ortega, Casimiro Gomez [de]	Ortega, Casimiro Gomez
Ant.Ortmann	Ortmann	Ortmann, Anton	Ortmann, Anton
Arn.Ortmann	Ortmann	Ortmann, Arnold Edward	Ortmann, Arnold Edward
H.Osborn.	Osborn	Osborn, Henry Stafford	Osborn, Henry Stafford
Osten-Saken	Osten-Saken	Osten-Saken, Baron Friedrich von der (Fedor Romanovic)	Osten-Saken, Baron Friedrich von der
Ernst Otto	Otto	Otto, Ernst von	Otto, Ernst von
P'ei	P'ei Chien	Pei Chien	Pei Chien
Ed.Palmer	Palmer	Palmer, Edward	Palmer, Edward
Elm.Palmer	Palmer	Palmer, Elmore	Palmer, Elmore
Paléz.	Palézieux	Palézieux, Philippe de	Palézieux, Philippe de
Pancic	Pancic	Pancic, Josef (Giuseppe Pancio; Josif Panchic)	Pancic, Josef
Pansch	Pansch	Pansch, Adolf	Pansch, Adolf
D.Pantan.	Pantanelli	Pantanelli, Dante	Pantanelli, Dante
Pantu	Pantu	Pantu, Zacharia C. (Pantzu)	Pantu, Zacharia C.
Pool.	Paoletti	Paoletti, Giulio	Paoletti, Giulio
Papenfuss	Papenfuss	Papenfuss, George Frederick [Frederik]	Papenfuss, George Frederick
Par.	Paris	Paris, [Jean] Édouard Gabriel [Narcisse]	Paris, Édouard Gabriel
C.Parkinson	Parkinson	Parkinson, Charles Edward	Parkinson, Charles Edward
Jn.Parkinson	Parkinson	Parkinson, John	Parkinson, John
Js.Parkinson	Parkinson	Parkinson, James	Parkinson, James
S.Parkinson	Parkinson	Parkinson, Sydney	Parkinson, Sydney
H.E.Parks	Parks	Parks, Harold Ernest	Parks, Harold Ernest
Har.B.Parks	Parks	Parks, Harris Bradley	Parks, Harris Bradley
A.Parm.	Parmentier	Parmentier, Antoine Augustin	Parmentier, Antoine Augustin
T Parsons	Parsons	Parsons, Thomas Henry	Parsons, Thomas Henry
Pasch.	Pascher	Pascher, Adolf	Pascher, Adolf
W.Paterson	Paterson	Paterson, William	Paterson, William
R.Patrick	Patrick	Patrick, Ruth Myrtle	Patrick, Ruth Myrtle
W.Patrick	Patrick	Patrick, William	Patrick, William
F.Patterson	Patterson	Patterson, Flora (née Wambaugh)	Patterson, Flora
H.Patt.	Patterson	Patterson, Harry Norton	Patterson, Harry Norton
Jul.Pavillard	Pavillard	Pavillard, Jules	Pavillard, Jules
Pawl.	Pawlowski	Pawlowski, Bogumil	Pawlowski, Bogumil
Paxt.	Paxton	Paxton, [Sir] Joseph	Paxton, Joseph
Pennington	Pennington	Pennington, Leigh H [Humboldt]	Pennington, Leigh H
M.Perag.	Peragallo	Peragallo, Maurice	Peragallo, Maurice
N.Pereb.	Pereboom	Pereboom, Nicolaas Ewoud	Pereboom, Nicolaas Ewoud
H.Pereira	Pereira	Pereira, Huascar	Pereira, Huascar
Pernitzsch	Pernitzsch	Pernitzsch, Heinrich	Pernitzsch, Heinrich
Perreymond	Perreymond	Perreymond, Jean Honoré	Perreymond, Jean Honoré
A.Perrier	Perrier	Perrier, Alfred	Perrier, Alfred
Perrottet	Perrottet	Perrottet, George (Georges Guerrard) Samuel	Perrottet, George Samuel
W.Peters	Peters	Peters, Wilhelm Carl Hartwig	Peters, Wilhelm Carl Hartwig
N Petersen	Petersen	Petersen, Niels Frederick	Petersen, Niels Frederick
O.Petersen	Petersen	Petersen, Otto Georg	Petersen, Otto Georg
Petit, E.	Petit	Petit, Emil Charles Nicolai [Nicolai Emil Charles]	Petit, Emil Charles Nicolai
Petrovic	Petrovic	Petrovic, Sava	Petrovic, Sava
Petrowsky	Petrowsky [Petrowski	Petrowsky [Petrowski, Petrovsky], Andrei [Andreas] Stanislavovic	Petrowsky, Andrei Stanislavovic
Petterson	Petterson	Petterson, Bror Johan	Petterson, Bror Johan
Petzold	Petzold	Petzold, [Carl] Eduard Adolph	Petzold, Eduard Adolph
W.Petzold	Petzold	Petzold, [Karl] Wilhelm	Petzold, Wilhelm
Pfitz.	Pfitzer	Pfitzer, Ernst Hugo Heinrich	Pfitzer, Ernst Hugo Heinrich
W.Phelps	Phelps	Phelps, William	Phelps, William
J.Philib.	Philibert	Philibert, J.C.	Philibert, J.C.
F.Philippi	Philippi	Philippi, Federico (baptized Friedrich Heinrich Eunom)	Philippi, Federico
H.Phillips	Phillips	Phillips, Henry	Phillips, Henry
A.Piccioli	Piccioli	Piccioli, Antonio	Piccioli, Antonio
Picc	Piccone	Piccone, Antonio	Piccone, Antonio
Pic.-Ser.	Pichi-Sermolli	Pichi-Sermolli, Rodolfo Emilio Giuseppe	Pichi-Sermolli, Rodolfo Emilio Giuseppe
Piddington	Piddington	Piddington, Henry	Piddington, Henry
v.d.Pijl	Pijl	Pijl, Leendert van der	Pijl, Leendert van der
J.de A.Pinto	Pinto	Pinto, Joaquim de Almeida	Pinto, Joaquim de Almeida
Pinto da Silva	Pinto da Silva	Pinto da Silva, Antonio Rodrigo	Pinto da Silva, Antonio Rodrigo
Piscicelli	Piscicelli	Piscicelli, Maurizio	Piscicelli, Maurizio
Pitt.	Pittier	Pittier, Henry François (Pittier de Fabrega)	Pittier, Henry François
Playf.	Playfair	Playfair, George Israel	Playfair, George Israel
Plusz.	Pluszczewski	Pluszczewski, Emile	Pluszczewski, Emile
A.Plée	Plée	Plée, Auguste	Plée, Auguste
Jul.Pohl	Pohl	Pohl, Julius	Pohl, Julius
Polak.	Polakowsky	Polakowsky, Helmuth	Polakowsky, Helmuth
Poll.	Pollich	Pollich, Johann Adam	Pollich, Johann Adam
A.Ponce de Leon	Ponce de Leon y Aimé	Ponce de Leon y Aimé, Antonio	Ponce de Leon y Aimé, Antonio
M.Porsild	Porsild	Porsild, Morton Pedersen	Porsild, Morton Pedersen
Portenschl.	Portenschlag-Ledermayer	Portenschlag-Ledermayer, Franz [Edler] von	Portenschlag-Ledermayer, Franz von
C.L.Porter	Porter	Porter, Cedric Lambert	Porter, Cedric Lambert
Pospichal	Pospichal	Pospichal, Eduard	Pospichal, Eduard
H.v.Post	Post	Post, Hampus Adolf von	Post, Hampus Adolf von
T.v.Post	Post	Post, Tom [Tomas] Erik von	Post, Tom Erik von
Pottier-Alapetite	Pottier-Alapetite	Pottier-Alapetite, Germaine	Pottier-Alapetite, Germaine
F.Pouchet	Pouchet	Pouchet, Félix Archimède	Pouchet, Félix Archimède
T.Powell	Powell	Powell, Thomas	Powell, Thomas
B.Preiss	Preiss	Preiss, Balthazar (Preis)	Preiss, Balthazar
K.Presl	Presl	Presl, Karel Borivoj [Boriwog, Boriwag]	Presl, Karel Borivoj
G.Preuss	Preuss	Preuss, [Carl] Gotllieb Traugott	Preuss, Gotllieb Traugott
W.Prince	Prince	Prince, William	Prince, William
Procopianu	Procopianu-Procopovici	Procopianu-Procopovici, Aurel	Procopianu-Procopovici, Aurel
Préub.	Préaubert	Préaubert, Ernest	Préaubert, Ernest
Préfontaine	Préfontaine	Préfontaine, M. Bruletout de	Préfontaine, M. Bruletout de
Pröll	Pröli	Pröli, Alois	Pröli, Alois
Pugsl.	Pugsley	Pugsley, Herbert William	Pugsley, Herbert William
Purt.	Purton	Purton, Thomas	Purton, Thomas
Putterl.	Putterlick	Putterlick, Alois [Aloys]	Putterlick, Alois
Puydt	Puydt	Puydt, Emile de	Puydt, Emile de
Perez Arb.	Pérez Arbeláez	Pérez Arbeláez, Enrique	Pérez Arbeláez, Enrique
Pöll	Pöll	Pöll, Josef	Pöll, Josef
Quaintance	Quaintance	Quaintance, Altus Lacy	Quaintance, Altus Lacy
Quekett	Quekett	Quekett, John Thomas	Quekett, John Thomas
Quintanilha	Quintanilha	Quintanilha, Aurélio Pereira da Silva	Quintanilha, Aurélio Pereira da Silva
Rabinowitsch	Rabinowitsch	Rabinowitsch, Lydia	Rabinowitsch, Lydia
Radermacher	Radermacher	Radermacher, Jacobus Cornelius Matthaeus	Radermacher, Jacobus Cornelius Matthaeus
Railonsala	Railonsala	Railonsala, Artturi Nikodemus (orig. A.N. Helenius)	Railonsala, Artturi Nikodemus
Rainville	Rainville	Rainville, Frédéric	Rainville, Frédéric
Ramírez Goyena	Ramírez Goyena	Ramírez Goyena, Miguel	Ramírez Goyena, Miguel
I.Rand	Rand	Rand, Isaac	Rand, Isaac
E.F.A.Raoul	Raoul	Raoul, Édouard François Armand	Raoul, Édouard François Armand
Rasmussen	Rasmussen	Rasmussen, Rasmus	Rasmussen, Rasmus
Js.Rattray	Rattray	Rattray, James	Rattray, James
Ravenscroft	Ravenscroft	Ravenscroft, Edward James	Ravenscroft, Edward James
Rech.fil.	Rechinger	Rechinger, Karl Heinz	Rechinger, Karl Heinz
Redtenbacher	Redtenbacher	Redtenbacher, Joseph	Redtenbacher, Joseph
Reguis	Reguis	Reguis, J. Marius F.	Reguis, J. Marius F.
Rehd.	Rehder	Rehder, Alfred	Rehder, Alfred
Rehsteiner	Rehsteiner	Rehsteiner, Hugo	Rehsteiner, Hugo
G.Reichel	Reichel	Reichel, Georg Christian	Reichel, Georg Christian
Rchb.fil.	Reichenbach	Reichenbach, Heinrich Gustav	Reichenbach, Heinrich Gustav
Reichgelt	Reichgelt	Reichgelt, Theodoras Johannes	Reichgelt, Theodoras Johannes
L.Reinhardt	Reinhardt	Reinhardt, Ludwig	Reinhardt, Ludwig
Reinhardt	Reinhardt	Reinhardt, Otto Wilhelm Hermann	Reinhardt, Otto Wilhelm Hermann
Resvoll-Holmsen	Resvoll-Holmsen	Resvoll-Holmsen, Hanna [Marie]	Resvoll-Holmsen, Hanna
Retzdorff	Retzdorff	Retzdorff, Adolf Eduard Willy	Retzdorff, Adolf Eduard Willy
J.Reverchon	Reverchon	Reverchon, Julien	Reverchon, Julien
P.Reverchon	Reverchon	Reverchon, P.	Reverchon, P.
Reverchon	Reverchon	Reverchon, Elisée	Reverchon, Elisée
Rey-Pailhade	Rey-Pailhade	Rey-Pailhade, Constantin de	Rey-Pailhade, Constantin de
P.Richards	Richards	Richards, Paul Westmacott	Richards, Paul Westmacott
Richer de Belleval	Richer de Belleval	Richer de Belleval, Pierre	Richer de Belleval, Pierre
Al.Richt.	Richter	Richter, [Vincenz] Aladár	Richter, Aladár
Richer	Ricker	Ricker, Percy Leroy	Ricker, Percy Leroy
Riddelsdell	Riddelsdell	Riddelsdell, Harry Joseph	Riddelsdell, Harry Joseph
J.Riley	Riley	Riley, John	Riley, John
C Ritter berol.	Ritter	Ritter, Carl of Berlin	Ritter, Carl of Berlin
Chr.Ritter	Ritter	Ritter, Christian Wilhelm Jonathan	Ritter, Christian Wilhelm Jonathan
Rittershausen	Rittershausen	Rittershausen, Paul	Rittershausen, Paul
Ritzberger	Ritzberger	Ritzberger, Engelbert	Ritzberger, Engelbert
Riv.-God.	Rivas Goday	Rivas Goday, Salvador	Rivas Goday, Salvador
Riv.Mat.	Rivas Mateos	Rivas Mateos, Marcelo	Rivas Mateos, Marcelo
G.N.Robert	Robert	Robert, Gaspard Nicolas	Robert, Gaspard Nicolas
D.Robertson	Robertson	Robertson, David	Robertson, David
B.L.Robinson	Robinson	Robinson, Benjamin Lincoln	Robinson, Benjamin Lincoln
C.B.Robinson	Robinson	Robinson, Charles Budd, Jr.	Robinson, Charles Budd, Jr.
J.F.Robinson	Robinson	Robinson, James Fraser	Robinson, James Fraser
J.Robinson	Robinson	Robinson, John	Robinson, John
S.Robson	Robson	Robson, Stephen	Robson, Stephen
D.Roche	Roche	Roche, Daniel de la	Roche, Daniel de la
F.Roche	Roche	Roche, François de la	Roche, François de la
J.Rodríguez	Rodríguez y Femenías	Rodríguez y Femenías, Juan Joaquín	Rodríguez y Femenías, Juan Joaquín
C.C.Rogers	Rogers	Rogers, Charles Coltman [Coltman-Rogers, C.]	Rogers, Charles Coltman
W.E Rogers	Rogers	Rogers, Walter E	Rogers, Walter E
Roivainen	Roivainen	Roivainen, Heikki	Roivainen, Heikki
Rolander	Rolander	Rolander, Daniel	Rolander, Daniel
Romagnesi	Romagnesi	Romagnesi, Henri Charles Louis	Romagnesi, Henri Charles Louis
J.Rose	Rose	Rose, Joseph Nelson	Rose, Joseph Nelson
C.Rosenberg	Rosenberg	Rosenberg, Caroline Friderike	Rosenberg, Caroline Friderike
M.Rosenberg	Rosenberg	Rosenberg, Mary Elizabeth (afterwards Duffield)	Rosenberg, Mary Elizabeth
O.Rosenberg	Rosenberg	Rosenberg, [Gustaf] Otto	Rosenberg, Otto
Rosenstock	Rosenstock	Rosenstock, Eduard	Rosenstock, Eduard
Rosenvinge	Rosenvinge	Rosenvinge, (Janus) Lauritz (Andreas) Kolderup	Rosenvinge, Lauritz Kolderup
Roshevitz	Roshevitz	Roshevitz, Romain U. (Julievich)	Roshevitz, Romain U.
Rossmässler	Rossmässler	Rossmässler, Emil Adolph	Rossmässler, Emil Adolph
Rost.	Rostafinsky	Rostafinsky, Józef Thomasz (Joseph Thomas)	Rostafinsky, Józef Thomasz
Rot von Schr.	Rot von Schreckenstein	Rot von Schreckenstein, Friedrich, Freiherr	Rot von Schreckenstein, Friedrich, Freiherr
Rath	Roth	Roth, Albrecht Wilhelm	Roth, Albrecht Wilhelm
Rothschild	Rothschild	Rothschild, Jules	Rothschild, Jules
Rottenbach	Rottenbach	Rottenbach, Heinrich	Rottenbach, Heinrich
Roxas	Roxas Clemente y Rubio	Roxas Clemente y Rubio, Simon de	Roxas Clemente y Rubio, Simon de
Roy	Roy	Roy, John	Roy, John
Rubel	Rubel	Rubel, Franz	Rubel, Franz
G.M.Ruchinger	Ruchinger	Ruchinger, Giuseppe Maria	Ruchinger, Giuseppe Maria
Ruchinger	Ruchinger	Ruchinger, Giuseppe [baptised Josef]	Ruchinger, Giuseppe
J.H.Rudolph	Rudolph	Rudolph, Johann Heinrich	Rudolph, Johann Heinrich
S.Ruiz	Ruiz	Ruiz, Sebastian Joseph Lopez	Ruiz, Sebastian Joseph Lopez
Rupprecht	Rupprecht	Rupprecht, Johann Baptist	Rupprecht, Johann Baptist
Al.Russell	Russell	Russell, Alexander	Russell, Alexander
An.Russell	Russell	Russell, Anna (née Worsley)	Russell, Anna
Rulenberg	Rutenberg	Rutenberg, Diedrich Christian	Rutenberg, Diedrich Christian
Rutherford	Rutherford	Rutherford, Daniel	Rutherford, Daniel
Ras.	Räsänen	Räsänen, Veli Johannes Paavo Bartholomeus	Räsänen, Veli Johannes Paavo Bartholomeus
Réaubourg	Réaubourg	Réaubourg, Gaston	Réaubourg, Gaston
C.Röm.	Römer	Römer, Carl	Römer, Carl
Heim.Röm.	Römer	Römer, Heinrich	Römer, Heinrich
Jul.Röm.	Römer	Römer, Julius	Römer, Julius
Römmp	Römmp	Römmp, Herman	Römmp, Herman
Rüggeberg	Rüggeberg	Rüggeberg, Hermann Karl August	Rüggeberg, Hermann Karl August
Sabransky	Sabransky	Sabransky, Heinrich	Sabransky, Heinrich
D.Sacc	Saccardo	Saccardo, Domenico	Saccardo, Domenico
Sadebeck	Sadebeck	Sadebeck, Richard Emil Benjamin	Sadebeck, Richard Emil Benjamin
John Sadler	Sadler	Sadler, John	Sadler, John
Jos.Sadler	Sadler	Sadler, Joseph	Sadler, Joseph
C.Sahlberg	Sahlberg	Sahlberg, Carl Reinhold	Sahlberg, Carl Reinhold
Saint-Amans	Saint-Amans	Saint-Amans, Jean Florimond Boudon de	Saint-Amans, Jean Florimond Boudon de
Saint-Cyr	Saint-Cyr	Saint-Cyr, Dominique Napoléon	Saint-Cyr, Dominique Napoléon
Saint-Gal	Saint-Gal	Saint-Gal, Marie Joseph	Saint-Gal, Marie Joseph
Saint-Germain	Saint-Germain	Saint-Germain, J.J. de	Saint-Germain, J.J. de
St.Hil.	Saint-Hilaire	Saint-Hilaire, Auguste François César Prouvençal de	Saint-Hilaire, Auguste François César Prouvençal de
St.Lag.	Saint-Lager	Saint-Lager, Jean Baptiste	Saint-Lager, Jean Baptiste
Saint-Moulin	Saint-Moulin	Saint-Moulin, Vincentius Josephus de	Saint-Moulin, Vincentius Josephus de
Saint-Simon	Saint-Simon	Saint-Simon, Maximilien Henri, Marquis de	Saint-Simon, Maximilien Henri, Marquis de
Saint-Yves	Saint-Yves	Saint-Yves, Alfred [Marie Augustine]	Saint-Yves, Alfred
J.D.Salmon	Salmon	Salmon, John Drew	Salmon, John Drew
San Giorgio	San Giorgio (Sangiorgio)	San Giorgio (Sangiorgio), Paolo	San Giorgio, Paolo
Sand	Sand	Sand, Austin Westman William	Sand, Austin Westman William
K.Sandberger	Sandberger	Sandberger, Karl [Carl] Ludwig Fridolin von	Sandberger, Karl Ludwig Fridolin von
A.Sanderson	Sanderson	Sanderson, Arthur Rufus	Sanderson, Arthur Rufus
J.Sanderson	Sanderson	Sanderson, John	Sanderson, John
Sandif.	Sandifort	Sandifort, Gerard	Sandifort, Gerard
C.I.Sandw.	Sandwith	Sandwith, Mrs. Cecil Ivry	Sandwith, Mrs. Cecil Ivry
Sandw.	Sandwith	Sandwith, Noel Yvri	Sandwith, Noel Yvri
Sanguinetti	Sanguinetti	Sanguinetti, Pietro	Sanguinetti, Pietro
F.L.Sargent	Sargent	Sargent, Frederick LeRoy	Sargent, Frederick LeRoy
Sartorelli	Sartorelli	Sartorelli, Giovanni Battista	Sartorelli, Giovanni Battista
Sassenfeld	Sassenfeld	Sassenfeld, Joseph	Sassenfeld, Joseph
W.Saunders, Can.	Saunders	Saunders, William of Canada	Saunders, William of Canada
W.Saunders, U.S.A.	Saunders	Saunders, William	Saunders, William
W.W.Saunders	Saunders	Saunders, William Wilson	Saunders, William Wilson
N.T.Saussure	Saussure	Saussure, Nicolas Théodore de	Saussure, Nicolas Théodore de
Saussure	Saussure	Saussure, Horace Bénédict de	Saussure, Horace Bénédict de
S.Savage	Savage	Savage, Spencer	Savage, Spencer
Savastano	Savastano	Savastano, Luigi Salvatore	Savastano, Luigi Salvatore
V.Savicz	Savicz	Savicz, Vsevolod Pavlovicz	Savicz, Vsevolod Pavlovicz
Savul.	Savulescu	Savulescu, Trajan	Savulescu, Trajan
Scannagatta	Scannagatta	Scannagatta, Josue	Scannagatta, Josue
Schaarschmidt	Schaarschmidt	Schaarschmidt, Julius (after 1886 Gyula [von] Istvánffi de Csík Madéfalva)	Schaarschmidt, Julius
H.Schaefer	Schaefer	Schaefer, Hermann	Schaefer, Hermann
J.Schaefer	Schaefer	Schaefer, Johannes [Bernhard]	Schaefer, Johannes
M.Schaefer	Schaefer	Schaefer, Michael	Schaefer, Michael
Cä.Schaeff.	Schaeffer	Schaeffer, Cäsar	Schaeffer, Cäsar
Schaffranek	Schaffranek	Schaffranek, A.	Schaffranek, A.
Schafhäutl	Schafhäutl	Schafhäutl, [Karl Franz] Emil	Schafhäutl, Emil
Schagerström	Schagerström	Schagerström, Johan August	Schagerström, Johan August
Scharlok	Scharlok	Scharlok, [Carl] Julius [Adolf]	Scharlok, Julius
W.Schatz	Schatz	Schatz, [Jakob] Wilhelm	Schatz, Wilhelm
J.Scheuchzer, fil.	Scheuchzer	Scheuchzer, Johannes fil.	Scheuchzer, Johannes fil.
Scheuermann	Scheuermann	Scheuermann, Richard	Scheuermann, Richard
Schiederm.	Schiedermayr	Schiedermayr, Karl [Carl] B.	Schiedermayr, Karl B.
C.Schiem.	Schiemann	Schiemann, Carl Christianus	Schiemann, Carl Christianus
E.Schiern.	Schiemann	Schiemann, Elisabeth	Schiemann, Elisabeth
Schilberszky	Schilberszky	Schilberszky, Károly	Schilberszky, Károly
Schildknecht	Schildknecht	Schildknecht, J.	Schildknecht, J.
S.Schiller	Schiller	Schiller, Sigismund	Schiller, Sigismund
A.Schilling	Schilling	Schilling, August Jakob	Schilling, August Jakob
W.Schimp.	Schimper	Schimper, Wilhelm Philipp	Schimper, Wilhelm Philipp
Schindehütte	Schindehütte	Schindehütte, G.	Schindehütte, G.
Schiudl.	Schindler	Schindler, Anton Karl	Schindler, Anton Karl
Schischkin	Schischkin	Schischkin, Boris Konstantinovich	Schischkin, Boris Konstantinovich
Schlagdenhauffen	Schlagdenhauffen	Schlagdenhauffen, Charles Frédéric	Schlagdenhauffen, Charles Frédéric
A.Schlagintweit	Schlagintweit	Schlagintweit, Adolf von	Schlagintweit, Adolf von
H.Schlagintweit	Schlagintweit-Sakünlünski	Schlagintweit-Sakünlünski, Hermann Alfred Rudolph von	Schlagintweit-Sakünlünski, Hermann Alfred Rudolph von
D.F.C.Schlechtend.	Schlechtendal	Schlechtendal, Diederich Friedrich Carl von	Schlechtendal, Diederich Friedrich Carl von
D.H.R.Schlechtend.	Schlechtendal	Schlechtendal, Diederich [Dietrich] Hermann Reinhard von	Schlechtendal, Diederich Hermann Reinhard von
Schlechtend.	Schlechtendal	Schlechtendal, Diederich Franz Leonhard von	Schlechtendal, Diederich Franz Leonhard von
Schlechter	Schlechter	Schlechter, [Friedrich Richard] Rudolf	Schlechter, Rudolf
Schlesinger	Schlesinger	Schlesinger, Karl	Schlesinger, Karl
J.Schlickum	Schlickum	Schlickum, Julius	Schlickum, Julius
O.Schlickum	Schlickum	Schlickum, Oscar	Schlickum, Oscar
Schlieben	Schlieben	Schlieben, Hans-Joachim Eberhardt	Schlieben, Hans-Joachim Eberhardt
Schlotterbeck	Schlotterbeck	Schlotterbeck, Julius Otto	Schlotterbeck, Julius Otto
Schlotthauber	Schlotthauber	Schlotthauber, August Friedrich	Schlotthauber, August Friedrich
Schögl	Schlögl	Schlögl, Ludwig [Ludvík]	Schlögl, Ludwig
Schlümbach	Schlümbach	Schlümbach, Friedrich Alexander von	Schlümbach, Friedrich Alexander von
E.E.Schmid	Schmid	Schmid, Ernst Ehrhard Friedrich Wilhelm	Schmid, Ernst Ehrhard Friedrich Wilhelm
Ad.Schmidt	Schmidt	Schmidt, Adolf Wilhelm Ferdinand	Schmidt, Adolf Wilhelm Ferdinand
Alfr.Schmidt	Schmidt	Schmidt, Alfred	Schmidt, Alfred
Franz Schmidt	Schmidt	Schmidt, Franz	Schmidt, Franz
Friedr.Schmidt	Schmidt	Schmidt, Friedrich [Karl] [Fedor Bogdanovich]	Schmidt, Friedrich
Johs.Schmidt	Schmidt	Schmidt, [Ernst] Johannes	Schmidt, Johannes
Rob.Schmidt	Schmidt	Schmidt, Robert	Schmidt, Robert
E.Schmidtke	Schmidtke	Schmidtke, Ernst	Schmidtke, Ernst
J.Schmitt	Schmitt	Schmitt, Joseph	Schmitt, Joseph
Fe.Schneid.	Schneider	Schneider, Ferdinand	Schneider, Ferdinand
Geo.Schneid.	Schneider	Schneider, George	Schneider, George
Jos.Schneid.	Schneider	Schneider, Josef	Schneider, Josef
Jos.Schneid.Traunst.	Schneider	Schneider, Joseph [Josef]	Schneider, Joseph
Ludw.Schneid.	Schneider	Schneider, [Eduard Karl] Ludwig [Pfeil]	Schneider, Ludwig
Rob.Schneid.	Schneider	Schneider, [Karl Friedrich] Robert	Schneider, Robert
Geo.Schneid.bis	Schneider, Georg	Schneider, Georg	Schneider, Georg
Schoenichen	Schoenichen	Schoenichen, Walther	Schoenichen, Walther
P.Schoenlein	Schoenlein	Schoenlein, Philipp	Schoenlein, Philipp
Ri.Schomb.	Schomburgk	Schomburgk, [Moritz] Richard	Schomburgk, Richard
Ro.Schomb.	Schomburgk	Schomburgk, Robert [Hermann]	Schomburgk, Robert
Schopf	Schopf	Schopf, James [Morton]	Schopf, James
Schopfer	Schopfer	Schopfer, William Henri	Schopfer, William Henri
F.Schrad.	Schrader	Schrader, Frank Charles	Schrader, Frank Charles
Aug.Schramm	Schramm	Schramm, [Johannes] Augustin	Schramm, Augustin
F.Schreiber	Schreiber	Schreiber, Franz	Schreiber, Franz
Ha.Schreiber	Schreiber	Schreiber, Hans	Schreiber, Hans
He.Schreiber	Schreiber	Schreiber, Herrmann [Hermann] Rudolf Ferdinand	Schreiber, Herrmann Rudolf Ferdinand
B.Schröd.	Schröder	Schröder, [Ludwig Julius] Bruno	Schröder, Bruno
Schuchardt	Schuchardt	Schuchardt, [Conrad Gideon] Theodor	Schuchardt, Theodor
J.Schuette	Schuette	Schuette, Joachim Heinrich	Schuette, Joachim Heinrich
E.Schüz	Schuez	Schuez, [Georg] Emil [Carl Christoph]	Schuez, Emil
J.H.Schult.	Schultes	Schultes, Julius Hermann (1804-1840)	Schultes, Julius Hermann
J.H.Schult.II	Schultes	Schultes, Julius Hermann (1820-1887)	Schultes, Julius Hermann
Arth.Schultz	Schultz	Schultz, Arthur	Schultz, Arthur
C.F.Schultz	Schultz	Schultz, Carl [Karl] Friedrich	Schultz, Carl Friedrich
Schultz-Bip.	Schultz	Schultz, Carl [Karl] Heinrich Bipontinus	Schultz, Carl Heinrich Bipontinus
Schultz-Sch.	Schultz-Schultzenstein	Schultz-Schultzenstein, Carl [Karl] Heinrich	Schultz-Schultzenstein, Carl Heinrich
Aug.Schulz	Schulz	Schulz, August [Albert Heinrich]	Schulz, August
F.Schultz.	Schulz	Schulz, Franz	Schulz, Franz
Ri.Schulz	Schulz	Schulz, Richard	Schulz, Richard
Ro.Schulz	Schulz	Schulz, Roman	Schulz, Roman
Schulz-Danz.	Schulz-Danzig	Schulz-Danzig, Paul	Schulz-Danzig, Paul
Erw.Schulze	Schulze	Schulze, Erwin	Schulze, Erwin
Wa.Schulze	Schulze	Schulze, Walther	Schulze, Walther
Wi.Schulze	Schulze	Schulze, Wilhelm	Schulze, Wilhelm
J.Schum.	Schumann	Schumann, Julius [Heinrich Karl]	Schumann, Julius
Schwaighofer	Schwaighofer	Schwaighofer, Anton	Schwaighofer, Anton
Schwanecke	Schwanecke	Schwanecke, Carl	Schwanecke, Carl
Schwant.	Schwantes	Schwantes, Gustav	Schwantes, Gustav
Schwappach	Schwappach	Schwappach, Adam F.	Schwappach, Adam F.
C.A.Schwarze	Schwarze	Schwarze, Carl Alois	Schwarze, Carl Alois
F.Schwarzenbach	Schwarzenbach	Schwarzenbach, Fritz	Schwarzenbach, Fritz
Schwarzenbach	Schwarzenbach	Schwarzenbach, Marthe	Schwarzenbach, Marthe
Schweizer	Schweizer	Schweizer, Jakob	Schweizer, Jakob
Schwertschlager	Schwertschlager	Schwertschlager, Joseph	Schwertschlager, Joseph
Schweykert	Schweykert	Schweykert, J.M.	Schweykert, J.M.
Schwickerath	Schwickerath	Schwickerath, Mathias [Friederich]	Schwickerath, Mathias
Schychowsky	Schychowsky	Schychowsky, Iwan	Schychowsky, Iwan
H.Schönach	Schönach	Schönach, Hugo	Schönach, Hugo
Schönau	Schönau	Schönau, Karl von	Schönau, Karl von
J.Schönlein	Schönlein	Schönlein, Johann Lucas	Schönlein, Johann Lucas
Shüepp	Schüep	Schüep, Otto	Schüep, Otto
C.Scofield	Scofield	Scofield, Carl Schurz	Scofield, Carl Schurz
Scortechini	Scortechini	Scortechini, Benedetto	Scortechini, Benedetto
Jo.Scott	Scott	Scott, John	Scott, John
Scott-Elliot	Scott-Elliot	Scott-Elliot, George Francis	Scott-Elliot, George Francis
Seat.	Seaton	Seaton, Henry Eliason	Seaton, Henry Eliason
Sebeòk	Sebeòk	Sebeòk, Alexander [Sándor], de Szent-Miklòs	Sebeòk, Alexander, de Szent-Miklòs
Sedgwick	Sedgwick	Sedgwick, Leonard John	Sedgwick, Leonard John
Segerstedt	Segerstedt	Segerstedt, Per Simeon Julius	Segerstedt, Per Simeon Julius
J.Seidel	Seidel	Seidel, Johann Heinrich	Seidel, Johann Heinrich
Selbstherr	Selbstherr	Selbstherr, Carl	Selbstherr, Carl
Seligmann	Seligmann	Seligmann, Johann Michael	Seligmann, Johann Michael
Senckenberg	Senckenberg	Senckenberg, Johann Christian	Senckenberg, Johann Christian
Sergiev.	Sergievskaja	Sergievskaja, Lidia Palladievna	Sergievskaja, Lidia Palladievna
Serguéeff	Serguéeff	Serguéeff, Marguérite	Serguéeff, Marguérite
De Seyn.	Seynes	Seynes, Jules de	Seynes, Jules de
J.Sheph.	Shepherd	Shepherd, John	Shepherd, John
Th.Sheph.	Shepherd	Shepherd, Thomas	Shepherd, Thomas
Shib.	Shibata	Shibata, Keita	Shibata, Keita
Shiras	Shirasawa	Shirasawa, Homi [Yasuyoshi]	Shirasawa, Homi
Shall	Shull	Shull, George Harrison	Shull, George Harrison
Shuttleworth	Shuttleworth	Shuttleworth, Robert James	Shuttleworth, Robert James
Sibilio	Sibilla	Sibilla, Cesare	Sibilla, Cesare
Sierstorpff	Sierstorpff	Sierstorpff, Kaspar Heinrich, Freiherr von	Sierstorpff, Kaspar Heinrich, Freiherr von
Sievers	Sievers	Sievers, Johann Erasmus	Sievers, Johann Erasmus
W.Sievers	Sievers	Sievers, Wilhelm	Sievers, Wilhelm
Sigriansky	Sigriansky	Sigriansky, Alexandre	Sigriansky, Alexandre
Silipranti	Silipranti	Silipranti, Giovanni	Silipranti, Giovanni
Silva-Tar.	Silva Tarouca	Silva Tarouca, Ernst Emanuel, Graf	Silva Tarouca, Ernst Emanuel, Graf
Jos.Simmonds	Simmonds	Simmonds, Joseph Henry	Simmonds, Joseph Henry
S.Simon	Simon	Simon, Siegfried Veit	Simon, Siegfried Veit
C.Simpson	Simpson	Simpson, Charles Torrey	Simpson, Charles Torrey
N.Simpson	Simpson	Simpson, Norman Douglas	Simpson, Norman Douglas
Sjöstrand	Sjöstrand	Sjöstrand, Magnus Gustaf	Sjöstrand, Magnus Gustaf
Skalinska	Skalinska	Skalinska, Maria	Skalinska, Maria
Skupienski	Skupienski	Skupienski, Frantiszek [François-Xavier]	Skupienski, Frantiszek
Skvortzov	Skvortzov [Skvortzow]	Skvortzov [Skvortzow], Boris Vasilievich	Skvortzov, Boris Vasilievich
Slater	Slater	Slater, Matthew B.	Slater, Matthew B.
Sleum.	Sleumer	Sleumer, Hermann Otto	Sleumer, Hermann Otto
Js.Small	Small	Small, James	Small, James
Smielowsky	Smielowsky	Smielowsky, [Smelowsky], Timotheus	Smielowsky, Timotheus
Ch.P.Sm.	Smith	Smith, Charles Piper	Smith, Charles Piper
Chr.Sm.	Smith	Smith, Christen	Smith, Christen
Eu.A.Sm.	Smith	Smith, Eugene Allen	Smith, Eugene Allen
H.H.Sm.	Smith	Smith, Herbert Huntington	Smith, Herbert Huntington
Ha.Sm.	Smith	Smith, [Karl August] Harald	Smith, Harald
He.Sm.	Smith	Smith, Henry (fl. 1810)	Smith, Henry
He.Sm., Madras	Smith	Smith, Henry (fl. 1857)	Smith, Henry
Hu.H.Sm.	Smith	Smith, Huron Herbert	Smith, Huron Herbert
John Sm.	Smith	Smith, John	Smith, John
Wm.Sm.	Smith	Smith, William	Smith, William
Wm.W.Sm.	Smith	Smith, William Wright	Smith, William Wright
Soltwedel	Soltwedel	Soltwedel, Friedrich [Wilhelm Otto]	Soltwedel, Friedrich
Somerville	Somerville	Somerville, Alexander	Somerville, Alexander
Soubeiran	Soubeiran	Soubeiran, Jean Léon	Soubeiran, Jean Léon
SoulatRibetté	Soulat-Ribette	Soulat-Ribette	Soulat-Ribette
Jean Soulié	Soulié	Soulié, Jean André	Soulié, Jean André
J.de C.Sowerby	Sowerby	Sowerby, James de Carle	Sowerby, James de Carle
Js.Sowerby II	Sowerby	Sowerby, James II	Sowerby, James II
Soyer-Will.	Soyer-Willemet	Soyer-Willemet, Hubert Félix	Soyer-Willemet, Hubert Félix
Spaendonck	Spaendonck	Spaendonck, Gerrit van	Spaendonck, Gerrit van
Spallanzani	Spallanzani	Spallanzani, Lazaro	Spallanzani, Lazaro
Spanoghe	Spanoghe	Spanoghe, Johan Baptist	Spanoghe, Johan Baptist
Sporleder	Sporleder	Sporleder, Friedrich Wilhelm	Sporleder, Friedrich Wilhelm
Spreitzenhofer	Spreitzenhofer	Spreitzenhofer, G.G.	Spreitzenhofer, G.G.
CK.Spreng.	Sprengel	Sprengel, Christian Konrad	Sprengel, Christian Konrad
Sprun.	Spruner	Spruner, Wilhelm von	Spruner, Wilhelm von
St.John	St. John	St. John, Harold	St. John, Harold
Stapf.	Stapf	Stapf, Otto	Stapf, Otto
Starb.	Starbäck	Starbäck, Karl	Starbäck, Karl
R.Stark	Stark	Stark, Robert Mackenzie	Stark, Robert Mackenzie
S.Stearns	Stearns	Stearns, Samuel	Stearns, Samuel
Stebb.	Stebbins	Stebbins, George Ledyard	Stebbins, George Ledyard
Steenhauer	Steenhauer	Steenhauer, Anna Johanna	Steenhauer, Anna Johanna
Steenis-Kruseman	Steenis-Kruseman	Steenis-Kruseman, Maria Johanna van (until 1927 M.J. Kruseman)	Steenis-Kruseman, Maria Johanna van
Stefur.	Stefureac	Stefureac, Traian I.	Stefureac, Traian I.
Steindórsson	Steindórsson	Steindórsson, Steindór [Jónas], frá hlöoum	Steindórsson, Steindór, frá hlöoum
Steinmann	Steinmann	Steinmann, [Johann Heinrich Conrad Gottfried] Gustav	Steinmann, Gustav
Steinvorth	Steinvorth	Steinvorth, Heinrich	Steinvorth, Heinrich
Steiler	Steller [Stöller]	Steller [Stöller], Georg Wilhelm	Steller, Georg Wilhelm
Stenström	Stenström	Stenström, Karl Otto Edvard	Stenström, Karl Otto Edvard
Geo.Stenzel	Stenzel	Stenzel, Georg	Stenzel, Georg
Sterbeeck	Sterbeeck	Sterbeeck, Frans [Franciscus] van	Sterbeeck, Frans van
F.C.Stern	Stern	Stern, [Sir] Frederick Claude	Stern, Frederick Claude
Sterne	Sterne	Sterne, Carus [pseudonym for Ernst Ludwig Krause]	Sterne, Carus
Sternen	Sternen	Sternen, Thomas Ray	Sternen, Thomas Ray
G.Stevens	Stevens	Stevens, George Thomas	Stevens, George Thomas
N.Stevens	Stevens	Stevens, Neil Everett	Stevens, Neil Everett
J.A.Stevenson	Stevenson	Stevenson, John Albert	Stevenson, John Albert
J.B.Stevenson	Stevenson	Stevenson, John Barr	Stevenson, John Barr
J.Stevenson	Stevenson	Stevenson, John	Stevenson, John
R.Stewart	Stewart	Stewart, Robert	Stewart, Robert
Stillingfleet	Stillingfleet	Stillingfleet, Benjamin	Stillingfleet, Benjamin
J.Stirling	Stirling	Stirling, James	Stirling, James
Stockmayer	Stockmayer	Stockmayer, Siegfried	Stockmayer, Siegfried
Stoltenberg	Stoltenberg	Stoltenberg, Nicolaus Theodor Marcus	Stoltenberg, Nicolaus Theodor Marcus
Strass.	Strasser	Strasser, Pius	Strasser, Pius
Stratingh	Stratingh	Stratingh, Gozewinus Acker	Stratingh, Gozewinus Acker
Th.Strauss	Strauss	Strauss, Theodor	Strauss, Theodor
Strohmeyer	Strohmeyer	Strohmeyer, Otto [August Karl]	Strohmeyer, Otto
A.Strong	Strong	Strong, Asa B.	Strong, Asa B.
Straehler	Strähler	Strähler, Adolf	Strähler, Adolf
Strömf	Strömfeit	Strömfeit, Harald Fredrik Georg	Strömfeit, Harald Fredrik Georg
Størm.	Størmer	Størmer, Per	Størmer, Per
Stützer	Stützer	Stützer, Olga	Stützer, Olga
Sue	Suc	Suc, Louis	Suc, Louis
Succow	Succow [Suckow]	Succow [Suckow], Friedrich Wilhelm Ludwig	Succow, Friedrich Wilhelm Ludwig
Suchlandt	Suchlandt	Suchlandt, Otto	Suchlandt, Otto
Sukachev	Sukachev	Sukachev, Vladimir Nikolaevich	Sukachev, Vladimir Nikolaevich
Sulzberger	Sulzberger	Sulzberger, Robert	Sulzberger, Robert
Sumstine	Sumstine	Sumstine, David [Ross]	Sumstine, David
Sutherland	Sutherland	Sutherland, James	Sutherland, James
W.Sutherland	Sutherland	Sutherland, William	Sutherland, William
Svens.	Svenson	Svenson, Henry Knute [Knut]	Svenson, Henry Knute
H.G.Svens.	Svensson	Svensson, Harry Gustaf	Svensson, Harry Gustaf
Swall.	Swallen	Swallen, Jason Richard	Swallen, Jason Richard
D.Swingle	Swingle	Swingle, Deane Bret	Swingle, Deane Bret
Szat.	Szatala	Szatala, Odön	Szatala, Odön
Sze	Sze	Sze, Hsing-chien [Ssu, H.C.]	Sze, Hsing-chien
Szepesfalvy	Szepesfalvy	Szepesfalvy, Janos	Szepesfalvy, Janos
Szymanski	Szymanski	Szymanski, Franz	Szymanski, Franz
Szysz.	Szyszylowicz	Szyszylowicz, Ignaz von	Szyszylowicz, Ignaz von
Séguier	Séguier	Séguier, Jean François	Séguier, Jean François
Sóo	Sóo [von Bere]	Sóo [von Bere], [Károly] Rezsö	Sóo, Rezsö
Söderberg	Söderberg	Söderberg, Daniel Henric	Söderberg, Daniel Henric
Sönnerberg	Sönnerberg	Sönnerberg, Jacob	Sönnerberg, Jacob
T.Sørensen	Sørengen	Sørengen, Thorvald Julius	Sørengen, Thorvald Julius
Tadulingam	Tadulingam	Tadulingam, Chinnakavanam	Tadulingam, Chinnakavanam
Tagliabue	Tagliabile	Tagliabile, Giuseppe	Tagliabile, Giuseppe
Tai	Tai	Tai, Fung-Ian [Tai, L.Y.]	Tai, Fung-Ian
Takamatsu	Takamatsu	Takamatsu, Masahiko	Takamatsu, Masahiko
Tamburlini	Tamburlini	Tamburlini, Francesco	Tamburlini, Francesco
Tamlander	Tamlander	Tamlander, Zacharias	Tamlander, Zacharias
Y.Tanaka	Tanaka	Tanaka, Yoshio	Tanaka, Yoshio
Tanfiljew	Tanfiljew	Tanfiljew, Gavriel Iwanowitsch [Gavriil Ivanovic]	Tanfiljew, Gavriel Iwanowitsch
T.Tang	Tang	Tang, T. (Tang, Chin)(	Tang, T.
Tardieu-Blot	Tardieu-Blot	Tardieu-Blot, Marie-Laure	Tardieu-Blot, Marie-Laure
G.Targioni	Targioni Tozetti	Targioni Tozetti, Giovanni (né Targioni)	Targioni Tozetti, Giovanni
Ad.Targioni	Targioni Tozzetti	Targioni Tozzetti, Adolfo	Targioni Tozzetti, Adolfo
An.Targioni	Targioni Tozzetti	Targioni Tozzetti, Antonio	Targioni Tozzetti, Antonio
O.Targioni	Targioni Tozzetti	Targioni Tozzetti, Ottaviano	Targioni Tozzetti, Ottaviano
Tarnavschi	Tarnavschi	Tarnavschi, Ion [Teofil]	Tarnavschi, Ion
Taubenhaus	Taubenhaus	Taubenhaus, Jacob Joseph	Taubenhaus, Jacob Joseph
J.Tavares	Tavares	Tavares, Joaquim da Silva	Tavares, Joaquim da Silva
Tavares	Tavares	Tavares, Carlos das Neves	Tavares, Carlos das Neves
Ad.Tayl	Taylor	Taylor, Adam	Taylor, Adam
F.Tayl.	Taylor	Taylor, Frederick Beatson	Taylor, Frederick Beatson
G.Tayl.	Taylor	Taylor, George	Taylor, George
J.E.Tayl.	Taylor	Taylor, John Ellor	Taylor, John Ellor
Jos.Tayl.	Taylor	Taylor, Joseph	Taylor, Joseph
N.Tayl.	Taylor	Taylor, Norman	Taylor, Norman
T.M.C.Tayl.	Taylor	Taylor, Thomas Mayne Cunninghame	Taylor, Thomas Mayne Cunninghame
T.Tayl.	Taylor	Taylor, Thomas (1820-1910)	Taylor, Thomas
Tayl.	Taylor	Taylor, Thomas (1786-1848)	Taylor, Thomas
W.R.Tayl.	Taylor	Taylor, William Randolph	Taylor, William Randolph
Tchihatcheff	Tchihatcheff	Tchihatcheff, Pierre de [Chikhachef Petr Aleksandrovich; Tschihatcheff]	Tchihatcheff, Pierre de
Teichmeyer	Teichmeyer	Teichmeyer, Hermann Friedrich	Teichmeyer, Hermann Friedrich
Teirlinck	Teirlinck	Teirlinck, Isidoor	Teirlinck, Isidoor
S.Teng	Teng	Teng, Shu-chün	Teng, Shu-chün
Teodoro	Teodoro y Gregorio	Teodoro y Gregorio, Nicanor Gonzalo	Teodoro y Gregorio, Nicanor Gonzalo
Teplouchow	Teplouchow	Teplouchow, Feodor [Theodor] Alexandrowitsch	Teplouchow, Feodor Alexandrowitsch
Terletzki	Terletzki	Terletzki, Paul	Terletzki, Paul
Ternisien	Ternisien	Ternisien, Théophile Antoine Timoléon	Ternisien, Théophile Antoine Timoléon
A.Terrac.	Terraciano	Terraciano, Achille	Terraciano, Achille
N.Terrac.	Terraciano	Terraciano, Nicola	Terraciano, Nicola
Tettelbach	Tettelbach	Tettelbach, [Ernst Gustav] Moritz	Tettelbach, Moritz
Theobald	Theobald	Theobald, Gottfried Ludwig	Theobald, Gottfried Ludwig
Thiébaut	Thiébaut	Thiébaut, Jean	Thiébaut, Jean
Thiébaut-de-Berneaud	Thiébaut-de-Berneaud	Thiébaut-de-Berneaud, Arsenne [Arsène]	Thiébaut-de-Berneaud, Arsenne
Em.Thomas	Thomas [Abraham Louis] Emmanuel [Emanuel]	Thomas [Abraham Louis] Emmanuel [Emanuel]	Thomas Emmanuel
Arn.Thomps.	Thompson	Thompson, Arnold	Thompson, Arnold
Chr.Thomsen	Thomsen	Thomsen, Christen	Thomsen, Christen
Sp.Thomson	Thomson	Thomson, Spencer	Thomson, Spencer
Th.Thomson	Thomson	Thomson, Thomas	Thomson, Thomas
Thormeyer	Thormeyer	Thormeyer, Paul	Thormeyer, Paul
H.Thorns	Thorns	Thorns, Hermann [Friedrich Maria]	Thorns, Hermann
Thorstenson	Thorstenson	Thorstenson, Georg Leonhard	Thorstenson, Georg Leonhard
Thouvenin	Thouvenin	Thouvenin, Maurice [-François]	Thouvenin, Maurice
Thurmann	Thurmann	Thurmann, Jules	Thurmann, Jules
Thuem.	Thümen [-Gräfendorf]	Thümen [-Gräfendorf], Felix [Karl Albert Ernst Joachim baron] von	Thümen, Felix von
Tiesenhausen	Tiesenhausen	Tiesenhausen, Manfred von	Tiesenhausen, Manfred von
G.Tobl.	Tobler	Tobler, Gertrud [Paula], née Wolff	Tobler, Gertrud, née Wolff
Tobl.	Tobler	Tobler, Friedrich	Tobler, Friedrich
Tollemache	Tollemache	Tollemache, Stanhope	Tollemache, Stanhope
Tommaselli	Tommaselli	Tommaselli, Giuseppe	Tommaselli, Giuseppe
Tong	Tong	Tong, Koeyang	Tong, Koeyang
Tourr.	Tourret	Tourret, Eugène Gilbert	Tourret, Eugène Gilbert
Toussaint	Toussaint	Toussaint, Anatole	Toussaint, Anatole
J.K.Townsend	Townsend	Townsend, John Kirk	Townsend, John Kirk
Townsend	Townsend	Townsend, Frederick	Townsend, Frederick
Cl.Tracy	Tracy	Tracy, Clarissa, née Tucker	Tracy, Clarissa, née Tucker
Tradescant Jr.	Tradescant	Tradescant, John	Tradescant, John
Traunfellner	Traunfellner	Traunfellner, Aloys	Traunfellner, Aloys
Treichel	Treichel	Treichel, Alexander [Johann August]	Treichel, Alexander
Tremols	Tremols y Borrell	Tremols y Borrell, Federico	Tremols y Borrell, Federico
Trinchinetti	Trinchinetti	Trinchinetti, Augusto	Trinchinetti, Augusto
Trinkwalter	Trinkwalter	Trinkwalter, Leopold	Trinkwalter, Leopold
Trott.	Trotter	Trotter, Alessandro	Trotter, Alessandro
Trotzky	Trotzky	Trotzky, [Petrus] Kornuch	Trotzky, Kornuch
Trouillard	Trouillard	Trouillard, Charles	Trouillard, Charles
Trozelius	Trozelius	Trozelius, Glas Blechert	Trozelius, Glas Blechert
Trzebinski	Trzebinski	Trzebinski, Józef [Joseph]	Trzebinski, Józef
Tub.	Tubeuf	Tubeuf, Carl [Karl] [Freiherr] von	Tubeuf, Carl von
Tullberg	Tullberg	Tullberg, Sven Axel Teodor	Tullberg, Sven Axel Teodor
E.Turn.	Turner	Turner, Edward Phillips	Turner, Edward Phillips
F.Turn.	Turner	Turner, Frederick	Turner, Frederick
Turn.	Turner	Turner, Dawson	Turner, Dawson
W.B.Turn.	Turner	Turner, William Harwell	Turner, William Harwell
W.Turn.	Turner	Turner, Wilhelm	Turner, Wilhelm
E.Twining	Twining	Twining, Elizabeth	Twining, Elizabeth
Uehlinger	Uehlinger	Uehlinger, Arthur Bernhard	Uehlinger, Arthur Bernhard
Ungern-Sternb.	Ungern-Sternberg	Ungern-Sternberg, Franz	Ungern-Sternberg, Franz
Unverricht	Unverricht	Unverricht, Carl	Unverricht, Carl
Urbino	Urbina y Altamirano	Urbina y Altamirano, Manuel	Urbina y Altamirano, Manuel
A.Vacc	Vaccari	Vaccari, Antonio	Vaccari, Antonio
M.Vahl II	Vahl	Vahl, Martin [II]	Vahl, Martin
Valck.-Suring.	Valckenier Suringar	Valckenier Suringar, Jan	Valckenier Suringar, Jan
Val.	Valeton	Valeton, Theodoric	Valeton, Theodoric
Van Bambeke	Van Bambeke	Van Bambeke, Charles Eugène Marie	Van Bambeke, Charles Eugène Marie
Van Bastelaer	Van Bastelaer	Van Bastelaer, Désiré Alexandre [Henri]	Van Bastelaer, Désiré Alexandre
Van Haesend.	Van Haesendonck	Van Haesendonck, [Gérard] Constant	Van Haesendonck, Constant
Van Hoorebeke	Van Hoorebeke	Van Hoorebeke, Charles Joseph	Van Hoorebeke, Charles Joseph
Vandendries	Vandendries	Vandendries, René François Prosper	Vandendries, René François Prosper
Vandercolme	Vandercolme	Vandercolme, Édouard	Vandercolme, Édouard
Vandevelde	Vandevelde	Vandevelde, Albert [Jacob Josef]	Vandevelde, Albert
Vauch.	Vaucher	Vaucher, Jean Pierre Etienne	Vaucher, Jean Pierre Etienne
Vaup.	Vaupel	Vaupel, Friedrich Karl Johann	Vaupel, Friedrich Karl Johann
Venten.	Ventenat	Ventenat, Étienne Pierre	Ventenat, Étienne Pierre
Vermeulen	Vermeiden	Vermeiden, Pieter	Vermeiden, Pieter
Vesterlund	Vesterlund	Vesterlund, [Per] Otto	Vesterlund, Otto
Veulliot	Veulliot	Veulliot, Charles	Veulliot, Charles
Viallanes	Viallanes	Viallanes, [Jacques Joseph] Alfred	Viallanes, Alfred
A.Vidal	Vidal	Vidal, António José Rodrigo	Vidal, António José Rodrigo
Vien.-Bourg.	Viennot-Bourgin	Viennot-Bourgin, Georges	Viennot-Bourgin, Georges
Vierh.sen.	Vierhapper	Vierhapper, Friedrich	Vierhapper, Friedrich
Ph.Vilm.	Vilmorin	Vilmorin, [Joseph Marie] Philippe [Levêque] de	Vilmorin, Philippe de
Vitm.	Vitman	Vitman, Fulgenzio	Vitman, Fulgenzio
Vogelsberger	Vogelsberger	Vogelsberger, Albert	Vogelsberger, Albert
J.P.Vogler	Vogler	Vogler, Johann Philipp	Vogler, Johann Philipp
Völkern	Volkens	Volkens, Georg Ludwig August	Volkens, Georg Ludwig August
Vollmann	Voümann	Voümann, Franz	Voümann, Franz
Wachendorff	Wachendorff	Wachendorff, Evert Jacob van	Wachendorff, Evert Jacob van
A.Wade	Wade	Wade, Arthur Edward	Wade, Arthur Edward
H.Wagner II	Wagner	Wagner, Hermann (of Hadamar)	Wagner, Hermann
Wahlstedt	Wahlstedt	Wahlstedt, Lars Johan	Wahlstedt, Lars Johan
Wahlström	Wahlström	Wahlström, Johan Erik	Wahlström, Johan Erik
Wahnschaffe	Wahnschaffe	Wahnschaffe, [Gustav Albert Bruno] Felix	Wahnschaffe, Felix
Wakk.	Wakker	Wakker, Jan Hendrik	Wakker, Jan Hendrik
J.Walcott	Walcott	Walcott, John	Walcott, John
Waldenburg	Waldenburg	Waldenburg, Ilse	Waldenburg, Ilse
Waldschmidt	Waldschmidt	Waldschmidt, J.	Waldschmidt, J.
Wallich	Wallich	Wallich, Nathaniel (b. Nathan Wulff [Wolff]	Wallich, Nathaniel
B.Walpole	Walpole	Walpole, Branson Alva	Walpole, Branson Alva
Ha.Walter	Walter	Walter, Hans Paul Heinrich	Walter, Hans Paul Heinrich
He.Walter	Walter	Walter, Heinrich [Karl]	Walter, Heinrich
Al.Walther	Walther	Walther, Alexander Wilhelm Hannibal Franz	Walther, Alexander Wilhelm Hannibal Franz
Au.Walther	Walther	Walther, Augustin Friedrich	Walther, Augustin Friedrich
F.Walther	Walther	Walther, Friedrich Ludwig	Walther, Friedrich Ludwig
K.Walther	Walther	Walther, Kurt Herbert	Walther, Kurt Herbert
Wanger.	Wangerin	Wangerin, Walther [Leonhard]	Wangerin, Walther
E.Warb.	Warburg	Warburg, Edmund Frederic	Warburg, Edmund Frederic
F.K.Ward	Ward	Ward, Francis [Frank] Kingdon	Ward, Francis Kingdon
Ri.Warner	Warner	Warner, Richard	Warner, Richard
Ro.Warner	Warner	Warner, Robert	Warner, Robert
Watanabe	Watanabe	Watanabe, Kiyohiko	Watanabe, Kiyohiko
Waterhouse	Waterhouse	Waterhouse, Benjamin	Waterhouse, Benjamin
E.Wats.	Watson	Watson, Elba Emanuel	Watson, Elba Emanuel
H.Wats.	Watson	Watson, Hewett Cottrell	Watson, Hewett Cottrell
J.F.Wats.	Watson	Watson, John Forbes	Watson, John Forbes
Kew	Watson	Watson, William (of Kew)	Watson, William
P.Wats.	Watson	Watson, Peter William	Watson, Peter William
S.Wats.	Watson	Watson, Sereno	Watson, Sereno
Wa.Wats.	Watson	Watson, Walter	Watson, Walter
D.Watt	Watt	Watt, David Allan Poe	Watt, David Allan Poe
D.Webb	Webb	Webb, David Allardice	Webb, David Allardice
P.Webb	Webb	Webb, Philip Barker	Webb, Philip Barker
G.H.Weber	Weber	Weber, Georg Heinrich	Weber, Georg Heinrich
Weber-van Bosse	Weber-van Bosse	Weber-van Bosse, Anna Antoinette	Weber-van Bosse, Anna Antoinette
Webst.	Webster	Webster, Angus Duncan	Webster, Angus Duncan
Wehmeyer	Wehmeyer	Wehmeyer, Lewis Edgar	Wehmeyer, Lewis Edgar
Wehrhahn	Wehrhahn	Wehrhahn, Wilhelm	Wehrhahn, Wilhelm
Weinhart	Weinhart	Weinhart, Max	Weinhart, Max
Weismann	Weismann	Weismann, August	Weismann, August
Em.Weiss	Weiss	Weiss, Emanuel	Weiss, Emanuel
F.W.Weiss	Weiss	Weiss, Friedrich Wilhelm	Weiss, Friedrich Wilhelm
Wengenmayr	Wengenmayr	Wengenmayr, Xaver	Wengenmayr, Xaver
Wernekinck	Wernekinck	Wernekinck, Franz	Wernekinck, Franz
C.A.Westerl.	Westerlund	Westerlund, Carl Agardh	Westerlund, Carl Agardh
Weyl.	Weyland	Weyland, Hermann [Gerhard]	Weyland, Hermann
J.Wheeler	Wheeler	Wheeler, James	Wheeler, James
Wheld.	Wheldon	Wheldon, James Alfred	Wheldon, James Alfred
J.White, Dubl.	White	White, John, of Dublin	White, John, of Dublin
J.White, R.N.	White	White, John, R.N.	White, John, R.N.
Widm.	Widmer	Widmer, Elisabeth	Widmer, Elisabeth
Wigg.	Wiggers	Wiggers, [Wichers], Fridrich Hindrich	Wiggers, Fridrich Hindrich
E.M.Wilcox	Wilcox	Wilcox, Edwin [Forrest] Mead	Wilcox, Edwin Mead
E.Wilcz.	Wilczek	Wilczek, Ernst	Wilczek, Ernst
R.Wilcz.	Wilczek	Wilczek, Rudolf	Wilczek, Rudolf
R.With.	Wilhelm	Wilhelm, Rudolph	Wilhelm, Rudolph
Wilkinson	Wilkinson	Wilkinson, Caroline Catherine, Lady, née Lucas	Wilkinson, Caroline Catherine, Lady, née Lucas
H.B.Williamson	Williamson	Williamson, Herbert Bennett	Williamson, Herbert Bennett
J.Williamson	Williamson	Williamson, John	Williamson, John
W.C.Williamson	Williamson	Williamson, William Crawford	Williamson, William Crawford
A.Wilm.	Wilmott	Wilmott, Alfred James	Wilmott, Alfred James
Wilms	Wilms	Wilms, Friedrich, Junior	Wilms, Friedrich, Junior
A.Wils.	Wilson	Wilson, Albert	Wilson, Albert
C.L.Wils.	Wilson	Wilson, Carl Louis	Wilson, Carl Louis
E.Wils.	Wilson	Wilson, Ernest Henry	Wilson, Ernest Henry
F.Wils.	Wilson	Wilson, Francis Robert Muter	Wilson, Francis Robert Muter
G.W.Wils.	Wilson	Wilson, Guy West	Wilson, Guy West
J.Wils.	Wilson	Wilson, John	Wilson, John
M.Wils.	Wilson	Wilson, Malcolm	Wilson, Malcolm
N.Wils.	Wilson	Wilson, Nathaniel	Wilson, Nathaniel
P.Wils.	Wilson	Wilson, Percy	Wilson, Percy
W.Wils.	Wilson	Wilson, William	Wilson, William
F.Wiltshear	Wiltshear	Wiltshear, Frederick Gilbert	Wiltshear, Frederick Gilbert
S.Wiltshear	Wiltshear	Wiltshear, Samuel Paul	Wiltshear, Samuel Paul
F.E.Wimm.	Wimmer	Wimmer, Franz Elfried	Wimmer, Franz Elfried
Winkelmann	Winkelmann	Winkelmann, Johannes	Winkelmann, Johannes
E.Winkl.	Winkler	Winkler, Eduard	Winkler, Eduard
Ha.Winkl.	Winkler	Winkler, Hans Karl Albert	Winkler, Hans Karl Albert
Hu.Winkl.	Winkler	Winkler, Hubert [J.P.]	Winkler, Hubert
E.Winslow	Winslow	Winslow, Evelyn James	Winslow, Evelyn James
F.Wint.	Winter	Winter, Ferdinand	Winter, Ferdinand
G.Wint.	Winter	Winter, [Heinrich] Georg	Winter, Georg
J.M.Wint.	Winter	Winter, John Mack	Winter, John Mack
Winterbottom	Winterbottom	Winterbottom, James Edward	Winterbottom, James Edward
Winterschmidt	Winterschmidt	Winterschmidt, Johann Samuel	Winterschmidt, Johann Samuel
Wisl	Wislizenus	Wislizenus, Friedrich [later Frederick] Adolph	Wislizenus, Friedrich Adolph
Wislouch	Wislouch	Wislouch, Stanislav [Michailovic]	Wislouch, Stanislav
Wisn.	Wisniewski	Wisniewski, Tadeusz	Wisniewski, Tadeusz
Witas.	Witasek	Witasek, Johanna	Witasek, Johanna
Her.Witte	Witte	Witte, [Bror Otto] Hernfrid	Witte, Hernfrid
Wohltmann	Wohltmann	Wohltmann, Ferdinand [Friedrich Wilhelm]	Wohltmann, Ferdinand
Wojinowic	Wojinowic	Wojinowic, Welislaw P.	Wojinowic, Welislaw P.
C.Wolf	Wolf	Wolf, Carl Brandt	Wolf, Carl Brandt
Wollenweb.	Wollenweber	Wollenweber, Hans Wilhelm	Wollenweber, Hans Wilhelm
Woloszack	Woloszcak	Woloszcak, Eustach	Woloszcak, Eustach
Woloszynska	Woloszynska	Woloszynska, Jadwiga	Woloszynska, Jadwiga
J-M.Wood	Wood	Wood, John Medley	Wood, John Medley
W.Wood	Wood	Wood, William	Wood, William
Woodforde	Woodforde	Woodforde, James	Woodforde, James
Woodr.-Peacock	Woodruffe-Peacock	Woodruffe-Peacock, [originally Peacock] Edward Adrian	Woodruffe-Peacock, Edward Adrian
Woot.	Wooton	Wooton, Elmer Ottis	Wooton, Elmer Ottis
Worsdell	Worsdell	Worsdell, Wilson Crosfield	Worsdell, Wilson Crosfield
Worsl.	Worsley	Worsley, Arthingon	Worsley, Arthingon
J.Wulff	Wulff	Wulff, Johann Christoph	Wulff, Johann Christoph
Wullschlaegel	Wullschlaegel	Wullschlaegel, Heinrich Rudolph	Wullschlaegel, Heinrich Rudolph
Wydl.	Wydler	Wydler, Heinrich	Wydler, Heinrich
Wächter	Wächter	Wächter, Wilhelm	Wächter, Wilhelm
O.Wünsche	Wünsche	Wünsche, [Friedrich] Otto	Wünsche, Otto
Yamamoto	Yamamoto	Yamamoto, Yoshimatsu [born Wakamori]	Yamamoto, Yoshimatsu
L.Yates	Yates	Yates, Lorenzo Gordin	Yates, Lorenzo Gordin
Aa.young	Young	Young, Aaron	Young, Aaron
Est.Young	Young	Young, Esther	Young, Esther
W.Young, Kirkc.	Young	Young, William of Kirkcaldy	Young, William of Kirkcaldy
Zab.	Zabel	Zabel, Hermann	Zabel, Hermann
Zamelis	Zamelis	Zamelis, [Zamels] Aleksandrs	Zamelis, Aleksandrs
Ro.Zander	Zander	Zander, Robert	Zander, Robert
Zannichelli	Zannichelli [Zanichelli]	Zannichelli [Zanichelli], Giovanni Gerolamo [Gian Girolamo]	Zannichelli, Giovanni Gerolamo
Zapat.	Zapalowicz	Zapalowicz, Hugo	Zapalowicz, Hugo
Zenk.	Zenker	Zenker, Jonathan Carl	Zenker, Jonathan Carl
H.Zillig	Zillig	Zillig, Hermann	Zillig, Hermann
A.Zimmerm.	Zimmermann	Zimmermann, [Philipp Wilhelm] Albrecht	Zimmermann, Albrecht
H.Zimmerm.	Zimmermann	Zimmermann, Hugo	Zimmermann, Hugo
J.G.Zimmerm.	Zimmermann	Zimmermann, Johann Georg von	Zimmermann, Johann Georg von
O.E.R.Zimmerm.	Zimmermann	Zimmermann, Oscar Emil Reinhold	Zimmermann, Oscar Emil Reinhold
W.Zimmerm.	Zimmermann	Zimmermann, Walter [Max]	Zimmermann, Walter
Žmuda	Zmuda	Zmuda, Antoni Jozef	Zmuda, Antoni Jozef
Zoh.	Zohary	Zohary, (né Schein) Michael	Zohary, Michael
Zsch.	Zschacke	Zschacke, [Georg] Hermann	Zschacke, Hermann
Zwackh.	Zwackh-Holzhausen	Zwackh-Holzhausen, [Philipp Franz] Wilhelm Ritter von	Zwackh-Holzhausen, Wilhelm Ritter von
Àvila	Àvila y Zumarán	Àvila y Zumarán, Pedro de	Àvila y Zumarán, Pedro de
Ährling	Ährling	Ährling, Johan Erik Ewald	Ährling, Johan Erik Ewald
Åmark	Åmark	Åmark, Frederik Wilhelm	Åmark, Frederik Wilhelm
Écorchard	Écorchard	Écorchard, Jean-Marie	Écorchard, Jean-Marie
Étienne	Étienne	Étienne, Georges	Étienne, Georges
Évrard	Évrard	Évrard, Francis	Évrard, Francis
orst.	Örsted	Örsted, Anders Sandö (Ørsted, Oersted)	Örsted, Anders Sandö
